id,label,interval,followers,popularity,id,componentnumber,strongcompnum,indegree,outdegree,unique_collabs,weighted_indegree,weighted_outdegree,total_collabs,eccentricity,closnesscentrality,harmonicclosnesscentrality,betweenesscentrality,modularity_class,pageranks
Bad Bunny,Bad Bunny,,52915846,100,4q3ewBCX7sLwd24euuV69X,0,66,43,76,119,80,165,245,7,0.354419,0.427016,16172.97705,0,0.003245
Jhay Cortez,Jhay Cortez,,4404989,84,0EFisYRi20PTADoJrifHrz,0,66,33,49,82,68,120,188,6,0.342139,0.398586,2403.215884,0,0.002436
Tony Dize,Tony Dize,,2991179,75,3LKXWvXFWrkwUzJWxzwVpW,0,66,13,12,25,19,49,68,7,0.29981,0.336386,1241.701113,3,0.001405
Rauw Alejandro,Rauw Alejandro,,12993677,89,1mcTU81TzQhprhouKaTkpq,0,66,76,72,148,152,134,286,6,0.355376,0.42538,13977.908156,0,0.005561
Bomba Estéreo,Bomba Estéreo,,973375,79,5n9bMYfz9qss2VOW89EVs2,0,66,2,4,6,2,5,7,7,0.275357,0.296145,2390.747683,6,0.000306
Buscabulla,Buscabulla,,72671,70,0MoaBi6dSquXp6rrlqlF8R,0,56,2,0,2,2,0,2,0,0,0,0,0,0.000278
Tainy,Tainy,,976826,79,0GM7qgcRCORpGnfcN2tCiB,0,66,22,26,48,45,48,93,6,0.319838,0.368882,3386.983844,0,0.002194
ROSALÍA,ROSALÍA,,5637610,82,7ltDVBr6mKbRvohxheJ9h1,0,66,6,3,9,7,4,11,7,0.263421,0.288954,16.024338,0,0.000588
Zion & Lennox,Zion & Lennox,,6569769,78,21451j1KhjAiaYKflxBjr1,0,66,78,59,137,140,87,227,6,0.341253,0.405527,9626.301604,3,0.005926
Yandel,Yandel,,6079631,74,0eHQ9o50hj6ZDNBt6Ys1sD,0,66,58,68,126,108,122,230,6,0.35682,0.423439,11754.479078,0,0.004503
Don Omar,Don Omar,,7656495,79,33ScadVnbm2X8kkUqOkC6Z,0,66,32,31,63,72,73,145,7,0.324569,0.375341,8170.418759,3,0.002105
Nicky Jam,Nicky Jam,,17413553,81,1SupJlEpv7RS2tPNRaHViT,0,66,80,65,145,165,136,301,6,0.354419,0.421266,15706.712335,0,0.005859
Daddy Yankee,Daddy Yankee,,28854310,87,4VMYDCV2IEDYJArk749S6m,0,66,55,44,99,139,112,251,6,0.344677,0.399895,8081.297178,3,0.00378
Yaviah,Yaviah,,129467,59,0Y30TbA4p8SAfCzy2AFBa8,0,55,6,0,6,7,0,7,0,0,0,0,3,0.000613
Ñengo Flow,Ñengo Flow,,3554643,79,12vb80Km0Ew53ABfJOepVz,0,66,68,39,107,161,58,219,7,0.324836,0.379653,3917.988384,0,0.005007
Sech,Sech,,11017170,82,77ziqFxp5gaInVrF2lj4ht,0,66,33,46,79,95,137,232,7,0.332212,0.392269,1767.251457,0,0.002289
Mora,Mora,,610013,81,0Q8NcsJwoCbZOHHW63su5S,0,66,19,28,47,24,39,63,6,0.333052,0.379852,6695.606857,0,0.001624
Jowell & Randy,Jowell & Randy,,3605212,69,4IMAo2UQchVFyPH24PAjUs,0,66,41,64,105,66,102,168,6,0.341843,0.409831,7836.589699,3,0.003195
Anuel AA,Anuel AA,,23045207,85,2R21vXR83lH98kGeO99Y66,0,66,46,51,97,105,114,219,7,0.334179,0.395307,4275.591263,0,0.003585
Myke Towers,Myke Towers,,9204528,84,7iK8PXO48WeuP03g8YR51W,0,66,73,49,122,178,84,262,6,0.341843,0.400359,6683.731101,0,0.005604
Kendo Kaponi,Kendo Kaponi,,849085,63,1WMwuNKzEFtU6pPkdtryYS,0,66,13,17,30,20,35,55,7,0.294886,0.336679,179.523872,0,0.001019
Arcangel,Arcangel,,8585676,80,4SsVbpTthjScTS7U2hmr1X,0,66,86,83,169,267,227,494,6,0.352521,0.429367,10875.024369,0,0.006348
Duki,Duki,,6514094,84,1bAftSH8umNcGZ0uyV7LMg,0,66,47,41,88,87,62,149,6,0.326851,0.381709,29520.020794,10,0.004772
Pablo Chill-E,Pablo Chill-E,,826922,67,2XcZshqzPKm3iZcmt73R8D,0,66,26,9,35,57,30,87,8,0.235399,0.260008,4475.910777,10,0.002826
J Balvin,J Balvin,,34781550,88,1vyhD5VmyZ7KMfW5gqLgo5,0,66,41,37,78,115,101,216,7,0.325371,0.379442,3799.106151,0,0.003067
Marciano Cantero,Marciano Cantero,,3403,61,5QzDzXfXC5lepOBeQXBiVO,0,57,3,1,4,3,1,4,1,1,1,784,0,0.001712
El Alfa,El Alfa,,2334408,77,2oQX8QiMXOyuqbcZEFsZfm,0,66,42,31,73,95,65,160,6,0.31842,0.370738,5305.1267,0,0.004571
Julieta Venegas,Julieta Venegas,,1719535,75,2QWIScpFDNxmS6ZEMIUvgm,0,66,20,7,27,29,9,38,7,0.277485,0.30695,9865.502487,6,0.002596
Aventura,Aventura,,6218679,76,1qto4hHid1P71emI6Fd8xi,0,66,3,6,9,5,11,16,7,0.289271,0.318653,55.783843,3,0.000323
Nio Garcia,Nio Garcia,,3469420,74,5hdhHgpxyniooUiQVaPxQ0,0,66,52,38,90,100,70,170,7,0.322581,0.376869,2999.288781,0,0.00377
Luar La L,Luar La L,,179410,64,4axKuDPr6WKcDCyh8vueTY,0,66,28,25,53,45,35,80,7,0.301757,0.348556,1511.61863,0,0.002825
Ivy Queen,Ivy Queen,,1845952,63,6p2442ymrT9lZEuCZJdYcH,0,66,14,10,24,31,23,54,7,0.293244,0.330964,2201.822634,3,0.001067
Ricky Martin,Ricky Martin,,6717795,73,7slfeZO9LsJbWgpkIoXBUJ,0,66,12,10,22,17,15,32,7,0.304784,0.336742,2592.799227,6,0.001477
Omy de Oro,Omy de Oro,,198463,60,65jIUih0ZeTUJhSTRuYxpi,0,66,24,20,44,35,28,63,7,0.295217,0.339759,212.116794,0,0.002089
Eladio Carrion,Eladio Carrion,,1742961,78,5XJDexmWFLWOkjOEjOVX3e,0,66,58,41,99,85,82,167,6,0.337031,0.393502,7111.652441,0,0.004908
Lunay,Lunay,,7039421,73,47MpMsUfWtgyIIBEFOr4FE,0,66,34,34,68,50,67,117,6,0.326987,0.377215,2562.268462,0,0.002469
Marc Anthony,Marc Anthony,,7647532,76,4wLXwxDeWQ8mtUIRPxGiD6,0,66,15,6,21,30,6,36,7,0.289271,0.318041,2230.185506,6,0.001631
Pacho El Antifeka,Pacho El Antifeka,,168550,52,03Enzet8KLMkjdeQnbqbmn,0,66,30,25,55,43,37,80,7,0.310779,0.355793,5305.791606,0,0.002549
"Héctor ""El Father""","Héctor ""El Father""",,502798,63,2TjgzYcbTdsZjbT9OItIeB,0,66,8,21,29,18,49,67,7,0.310047,0.353029,226.218965,3,0.000615
Ñejo,Ñejo,,3221316,67,2OHKEe204spO7G7NcbeO2o,0,66,43,26,69,76,36,112,6,0.313866,0.36116,6150.590061,0,0.003706
Pj Sin Suela,Pj Sin Suela,,56812,55,0AdjzZxHJ4MfbImx2rD0Df,0,66,9,13,22,11,15,26,7,0.29379,0.326025,3409.833492,2,0.001463
DJ Nelson,DJ Nelson,,990782,72,2ydZrTy8U3kOMOzx20s3dg,0,66,21,34,55,58,83,141,6,0.318934,0.370992,8091.168788,3,0.001995
Bryant Myers,Bryant Myers,,7209077,76,6w9ToX5slZ4uIdmD17hJ3c,0,66,40,42,82,88,80,168,7,0.321792,0.379506,1605.227103,0,0.002931
Casper Magico,Casper Magico,,1901411,69,1fux65HMCBvfJHqlBc4Nno,0,66,37,33,70,84,74,158,7,0.322712,0.376046,1810.821391,0,0.00257
Darell,Darell,,3072112,75,1TtXnWcUs0FCkaZDPGYHdf,0,66,71,47,118,140,70,210,6,0.327393,0.38616,5488.481816,0,0.005347
Ozuna,Ozuna,,32957080,85,1i8SpTcr7yvPOmcqrbnVXY,0,66,58,61,119,137,136,273,6,0.350644,0.414409,8420.155198,0,0.004143
Cosculluela,Cosculluela,,4782377,70,00me4Ke1LsvMxt5kydlMyU,0,66,52,41,93,99,64,163,6,0.334038,0.389241,3309.291972,3,0.003513
Noriel,Noriel,,6095466,72,3RtNN1VnooWEn3KQk03DUL,0,66,51,53,104,117,112,229,7,0.330268,0.391805,8457.970919,0,0.00429
Brytiago,Brytiago,,5273721,73,00XhexlJEXQstHimpZN910,0,66,57,44,101,88,70,158,6,0.327529,0.385549,4380.397827,0,0.004198
Revol,Revol,,722845,58,2wYOpkTJZGByNEOjEnSmoW,0,66,11,33,44,14,57,71,7,0.320487,0.372438,564.608187,0,0.001023
De La Ghetto,De La Ghetto,,6103096,81,3EiLUeyEcA6fbRPSHkG5kb,0,66,93,69,162,209,135,344,6,0.359745,0.4273,25317.288019,0,0.007387
KHEA,KHEA,,4301934,75,4m6ubhNsdwF4psNf3R8kwR,0,66,32,17,49,50,25,75,7,0.304666,0.342923,5277.490981,10,0.003009
Cazzu,Cazzu,,4802210,73,6w3SkAHYPsQ1bxV7VDlG5y,0,66,27,24,51,41,28,69,7,0.315874,0.363894,6020.593139,10,0.00248
Alex Sensation,Alex Sensation,,167347,58,0OROVBEZCocg0FcgJpyBse,0,66,7,16,23,7,16,23,7,0.31424,0.355666,99.443584,0,0.000651
Benny Benni,Benny Benni,,281789,50,5gUZ67Vzi1FV2SnrWl1GlE,0,66,9,14,23,26,28,54,7,0.291191,0.330479,76.597915,0,0.00067
Pusho,Pusho,,597400,58,2qbEtwBVyobgpNP5KcHE9J,0,66,33,23,56,52,29,81,7,0.304432,0.349253,531.562792,0,0.002354
Farruko,Farruko,,13668381,84,329e4yvIujISKGKz1BZZbO,0,66,103,71,174,287,128,415,7,0.345129,0.413999,17415.812163,0,0.007528
Miky Woodz,Miky Woodz,,3005363,71,1pf0MPKfKdvS8J779mS1Ay,0,66,61,36,97,111,58,169,7,0.325103,0.379675,3491.310113,0,0.004561
Natti Natasha,Natti Natasha,,8162707,76,1GDbiv3spRmZ1XdM1jQbT7,0,66,37,42,79,59,68,127,6,0.348478,0.402511,5568.439458,3,0.003385
Rvssian,Rvssian,,1916829,72,1fctva4kpRbg2k3v7kwRuS,0,66,8,7,15,12,9,21,7,0.28164,0.316248,69.525826,0,0.000789
KAROL G,KAROL G,,27055406,86,790FomKkXshlbRYZFtlgla,0,66,27,35,62,58,85,143,6,0.337463,0.387278,6064.018545,6,0.00221
Becky G,Becky G,,11962419,81,4obzFoKoKRHIphyHzJ35G3,0,66,35,27,62,55,37,92,6,0.330268,0.376477,4506.130306,6,0.002848
Amenazzy,Amenazzy,,2233045,64,6kq4GHwUcUojGIu0ziSNXf,0,66,30,20,50,46,27,73,6,0.303846,0.34673,1682.726805,0,0.002275
Lito Kirino,Lito Kirino,,199869,54,68w2t0wbrGnxSIUHzWs5bt,0,66,12,2,14,20,3,23,8,0.243752,0.264118,120.46715,0,0.001131
Nacho,Nacho,,4627251,66,2ayNSoKPCRAfjp6hQ76hRu,0,66,35,52,87,56,94,150,6,0.361391,0.418312,14920.824028,2,0.002859
DJ Luian,DJ Luian,,1558934,74,64aJYyrXljOodnUG6jvhRD,0,66,17,42,59,43,130,173,7,0.325639,0.382459,581.182868,0,0.00134
Almighty,Almighty,,424279,70,6P6GTRTigHBp8ZesNtpCKH,0,66,24,26,50,50,40,90,7,0.316,0.36305,23503.855618,0,0.002037
Quimico Ultra Mega,Quimico Ultra Mega,,233866,58,3tZdknQnzsVIIdaGCTj4RX,0,66,29,4,33,40,6,46,7,0.248897,0.272447,1191.796925,13,0.00317
Mark B.,Mark B.,,221738,51,0zZJhc1T0zBurhnBwQ2fcu,0,66,8,5,13,8,5,13,7,0.253449,0.279852,798.50442,0,0.001037
Kevin Roldan,Kevin Roldan,,4899214,68,1RBzGO6Nm3uyhUSxP7EDWO,0,66,27,29,56,37,59,96,6,0.325371,0.374473,3072.83427,0,0.002195
Messiah,Messiah,,92608,55,0tR60pwxQ5WKjPxQcKoCQ7,0,66,12,10,22,18,12,30,7,0.279448,0.314352,401.925808,0,0.001441
Baby Rasta,Baby Rasta,,1681183,63,0GgyFUpOyzWDRDqx8FCTDN,0,66,18,11,29,30,17,47,8,0.267887,0.304806,419.383779,0,0.001183
Lary Over,Lary Over,,4445781,66,1jSjfSgDjedJdi5MoyRu78,0,66,20,27,47,44,35,79,7,0.30245,0.35151,744.506778,0,0.001505
Jory Boy,Jory Boy,,1553994,65,5lFhCi03HDneWzvCxGctrT,0,66,34,26,60,65,40,105,7,0.308956,0.356088,939.617342,0,0.002512
Trap Capos,Trap Capos,,352280,59,2pQAUIesBqfT87PaM1ijtk,0,66,3,27,30,22,76,98,7,0.31213,0.360413,75.851515,0,0.000361
Justin Quiles,Justin Quiles,,3647339,80,14zUHaJZo1mnYtn6IBRaRP,0,66,56,54,110,145,108,253,6,0.35158,0.412595,8974.99642,0,0.004121
Zion,Zion,,3092804,73,1pgDilWYDWLoOgGjf1iHNu,0,66,45,21,66,85,24,109,7,0.308473,0.354011,1285.477708,3,0.003366
Feid,Feid,,1779611,85,2LRoIwlKmHjgvigdNGBHNo,0,66,35,41,76,66,70,136,6,0.339201,0.392869,8911.489726,0,0.003723
Tokischa,Tokischa,,169149,64,2p4aN0Uxkk3iT3HK0cJ2cJ,0,66,8,8,16,12,9,21,7,0.260382,0.290256,110.783502,13,0.001019
Maria Becerra,Maria Becerra,,2884355,81,1DxLCyH42yaHKGK3cl5bvG,0,66,22,23,45,39,30,69,6,0.324569,0.367679,3576.164447,10,0.002094
Jay Wheeler,Jay Wheeler,,2706806,78,2cPqdH7XMvwaBJEVjheH8g,0,66,52,22,74,108,47,155,6,0.309925,0.354114,1604.67391,0,0.004014
Wisin & Yandel,Wisin & Yandel,,5508912,79,1wZtkThiXbVNtj6hee6dz9,0,66,38,50,88,72,130,202,7,0.346036,0.403683,6350.610621,3,0.002738
BIA,BIA,,357591,67,6veh5zbFpm31XsPdjBgPER,0,66,4,1,5,5,1,6,7,0.253368,0.272993,4.359511,0,0.000508
Fuego,Fuego,,249378,66,7wU2WGCJ8HxkekHHE2QLul,0,66,21,16,37,28,27,55,7,0.312747,0.353409,4119.160994,10,0.002151
Trueno,Trueno,,3655977,74,2x7PC78TmgqpEIjaGAZ0Oz,0,66,10,13,23,13,22,35,6,0.293353,0.33211,2815.796997,10,0.001214
Dímelo Flow,Dímelo Flow,,315119,71,3fZk3Gm5dN5v5yfYMQ04Bx,0,66,30,33,63,60,106,166,6,0.324302,0.375295,1617.377731,0,0.002579
Lenny Tavárez,Lenny Tavárez,,1894138,80,1pQWsZQehhS4wavwh7Fnxd,0,66,50,33,83,113,70,183,7,0.31945,0.372881,2501.828466,0,0.003855
KEVVO,KEVVO,,444817,64,4QrBoWLm2WNlPdbFhmlaUZ,0,66,46,29,75,68,38,106,7,0.312253,0.362966,2124.399758,0,0.004381
Maluma,Maluma,,31778738,83,1r4hJ1h58CWwUQe3MxPuau,0,66,45,51,96,84,75,159,6,0.347405,0.405148,12318.925572,6,0.00317
Wisin,Wisin,,8000710,76,3E6xrwgnVfYCrCs0ePERDz,0,66,66,65,131,156,165,321,6,0.365233,0.42827,17762.044286,3,0.005084
Juanka,Juanka,,600321,66,3Wb38LDP3N4tkobValgE9D,0,66,46,27,73,89,36,125,7,0.314741,0.36208,3889.438731,0,0.003303
Camilo,Camilo,,15980416,80,28gNT5KBp7IjEOQoevXf9N,0,66,17,15,32,31,20,51,6,0.322712,0.359198,2007.829233,6,0.001502
Dalex,Dalex,,4229316,75,0KPX4Ucy9dk82uj4GpKesn,0,66,46,36,82,100,107,207,7,0.321923,0.376257,1967.184575,0,0.003715
Manuel Turizo,Manuel Turizo,,10002778,80,0tmwSHipWxN12fsoLcFU3B,0,66,39,48,87,69,78,147,6,0.349403,0.408966,5678.552559,2,0.003033
Romeo Santos,Romeo Santos,,16003536,78,5lwmRuXgjX8xIwlnauTZIP,0,66,13,26,39,26,42,68,7,0.311391,0.356206,8018.014803,6,0.001229
R.K.M & Ken-Y,R.K.M & Ken-Y,,496580,63,3jFjgKOGfVLWfXX8q5wrsg,0,66,15,17,32,29,25,54,7,0.30245,0.341787,1528.891567,3,0.001077
Amarion,Amarion,,68502,52,7Bb4i0RT3zaudzb8KvxTUQ,0,66,11,11,22,14,11,25,7,0.283662,0.320193,171.661336,0,0.000996
Tiago PZK,Tiago PZK,,2266528,80,5Y3MV9DZ0d87NnVm56qSY1,0,66,20,19,39,35,33,68,6,0.303496,0.342131,4286.176304,10,0.002413
Boza,Boza,,445801,68,2NfSBtmWe7oPw1EmetJVso,0,66,13,11,24,18,15,33,6,0.29588,0.330549,256.699671,2,0.001239
Anthony Santos,Anthony Santos,,732835,60,06TVTkMAOR935MhkjX0i2A,0,66,5,4,9,10,5,15,7,0.268799,0.295597,135.115338,3,0.00043
Los Legendarios,Los Legendarios,,76105,68,0n6sKrG0xKAf8xmdqeNGke,0,66,13,24,37,41,61,102,6,0.317907,0.362848,413.343484,3,0.001173
Rochy RD,Rochy RD,,647160,64,4riOEaOW5hCeqomFDBk0aP,0,66,13,3,16,24,4,28,8,0.256161,0.282464,106.360394,13,0.00145
Morad,Morad,,1135256,74,4az97MtWmBQ5Db3GfDh9j9,0,66,7,5,12,13,6,19,7,0.272884,0.302538,830.709834,10,0.001001
Ovi,Ovi,,745492,66,4o0NtnL2m0lzZmEdRas1qv,0,66,17,27,44,23,39,62,7,0.326446,0.374358,2744.025229,0,0.002184
Flow La Movie,Flow La Movie,,13868,60,2oT7xd9iTO2ejLsNGIMa5f,0,66,9,13,22,21,27,48,7,0.291621,0.330434,11.750073,0,0.000901
Reik,Reik,,7449032,77,0vR2qb8m9WHeZ5ByCbimq2,0,66,35,36,71,48,47,95,6,0.348018,0.397553,13235.248568,6,0.003192
"Gotay ""El Autentiko""","Gotay ""El Autentiko""",,549463,60,6ieK9Ddas29reReO60on3o,0,66,18,18,36,41,30,71,7,0.299697,0.342345,532.759242,0,0.001276
"Secreto ""El Famoso Biberon""","Secreto ""El Famoso Biberon""",,379855,53,37UACiDcdzEYii0iU0QpAf,0,66,15,9,24,24,16,40,8,0.249526,0.277512,296.915484,13,0.001669
Lyanno,Lyanno,,722189,72,1Ts9of7VPZElwPQnqnDSfW,0,66,58,59,117,102,88,190,6,0.341548,0.406878,8716.758121,0,0.004469
Luis Fonsi,Luis Fonsi,,10480610,75,4V8Sr092TqfHkfAA5fXXqG,0,66,27,25,52,39,51,90,6,0.335456,0.379473,8715.163959,6,0.002053
Juhn,Juhn,,1029700,71,2LmcxBak1alK1bf7d1beTr,0,66,38,30,68,82,36,118,6,0.305019,0.354409,1974.696995,0,0.00339
Jon Z,Jon Z,,4522885,70,5bWUlnPx9OYKsLiUJrhCA1,0,66,64,25,89,132,44,176,7,0.298001,0.344708,6627.759937,0,0.005852
Ele A El Dominio,Ele A El Dominio,,1265746,63,4SzD0wClEg9NKVJZbCRFqS,0,66,17,8,25,25,14,39,8,0.255581,0.285113,2797.227061,0,0.001904
Chris Jedi,Chris Jedi,,1929247,72,0qTZZWLzuD59Un5r1speHm,0,66,5,8,13,9,13,22,6,0.289908,0.325063,32.411889,0,0.000518
Plan B,Plan B,,1959124,76,2jSGzJw0ebJLu7OLVSOcBP,0,66,24,24,48,39,39,78,7,0.30944,0.358273,570.662523,3,0.001872
Randy,Randy,,276120,68,7qYeIN2r4H1kBvr0Gm9Iav,0,66,38,43,81,62,77,139,7,0.319321,0.377185,3024.949293,0,0.003167
Yomo,Yomo,,840351,56,4myAXQmMuS1lZe8T6Y7eBg,0,66,33,16,49,66,16,82,7,0.300952,0.34113,1236.331085,3,0.002017
Dalmata,Dalmata,,1372903,62,3jGlU8UMMo44I2xeLQ6FD3,0,66,13,4,17,28,4,32,7,0.264391,0.289002,530.031572,2,0.001258
Farina,Farina,,325626,60,7cYik4OyfBXYV5Z2TI7p90,0,66,18,6,24,29,8,37,7,0.29879,0.326995,2383.81896,6,0.001564
Prince Royce,Prince Royce,,7124362,75,3MHaV05u0io8fQbZ2XPtlC,0,66,23,21,44,32,24,56,6,0.315243,0.358966,4296.799707,6,0.002252
Alexis y Fido,Alexis y Fido,,4505344,64,7tU1VKOuxiNZwBZC6RHidA,0,66,26,42,68,43,97,140,7,0.331376,0.387185,4149.587741,3,0.001582
Leslie Grace,Leslie Grace,,1192991,61,6BeO1KuAWBqFriL1mLHtNc,0,66,11,11,22,12,12,24,7,0.301412,0.336121,932.571795,6,0.001077
Luigi 21 Plus,Luigi 21 Plus,,1005517,58,77GVmrLGuxNEvj2ibvT62v,0,66,23,23,46,35,47,82,7,0.298903,0.345636,1268.98495,0,0.001573
Felipe Peláez,Felipe Peláez,,1096993,57,6dexNK5MjEL8UvmA5MjSgg,0,66,3,7,10,3,8,11,7,0.304902,0.335142,549.872054,6,0.000384
Piso 21,Piso 21,,8304103,73,4bw2Am3p9ji3mYsXNXtQcd,0,66,20,21,41,27,27,54,6,0.318035,0.361603,1627.875438,6,0.001858
Dyland & Lenny,Dyland & Lenny,,518141,50,6EiZOxfG8B5evnLH4KnJeF,0,66,2,12,14,2,23,25,7,0.299129,0.338327,108.903121,3,0.000296
Lalo Ebratt,Lalo Ebratt,,1749774,66,1GAymyGBvB4gQy5Z5LZ1Wj,0,66,29,35,64,55,57,112,6,0.339785,0.390295,6076.441249,2,0.002431
Blessd,Blessd,,973872,74,1TA5sGRlKUJXBN4ZyJuDIX,0,66,15,18,33,18,20,38,7,0.30303,0.34402,1150.518493,2,0.001444
Beéle,Beéle,,398648,70,7a0XAaPaK2aDSqa8p3QnC7,0,66,22,22,44,29,25,54,7,0.309682,0.353641,816.357942,2,0.001799
Carlos Rivera,Carlos Rivera,,3645418,72,39yVoqm6sYFvvqF1RciUVf,0,66,27,28,55,43,52,95,7,0.323241,0.370425,22191.627678,6,0.002217
Reykon,Reykon,,3075775,61,3PAwspMN27PDm81WwXDsMf,0,66,17,14,31,21,18,39,7,0.312006,0.349729,1393.830872,0,0.001316
Silvestre Dangond,Silvestre Dangond,,3714139,64,3OcvS8PzSGYMBvLdzY6g3e,0,66,15,4,19,18,4,22,7,0.276224,0.304373,1834.003279,6,0.001291
Shakira,Shakira,,24393175,85,0EmeFodog0BfCgMzAIvKQp,0,66,11,14,25,17,40,57,7,0.304314,0.342303,4453.250516,6,0.00112
Wolfine,Wolfine,,1458437,58,2OnKRchqP7tT0FzTvWIFI7,0,66,2,3,5,3,8,11,7,0.272414,0.297007,5.523741,0,0.000321
Pitbull,Pitbull,,9480300,82,0TnOYISbd1XYRBk9myaseg,0,66,34,23,57,88,53,141,7,0.313492,0.357408,9283.116572,6,0.00302
J Alvarez,J Alvarez,,4731828,66,6XFITTl7cFTdopDY3lUdlY,0,66,37,62,99,91,365,456,7,0.339201,0.40497,5124.764864,0,0.002602
Natalia Jiménez,Natalia Jiménez,,698736,63,0j8QSBQZ9MNSGjHr1Vll1R,0,66,10,10,20,13,13,26,7,0.304666,0.338442,3626.097437,6,0.000932
Baby Rasta & Gringo,Baby Rasta & Gringo,,2687722,62,3IEvQoAohcGX7CdrbtIle7,0,66,16,22,38,46,43,89,7,0.303263,0.348041,1024.809956,3,0.000894
"Tito ""El Bambino""","Tito ""El Bambino""",,3181179,68,5fJsY7afrbsyzJj9wdzJMh,0,66,32,48,80,50,93,143,7,0.334462,0.394379,5765.852098,3,0.002246
Yaga & Mackie,Yaga & Mackie,,415425,60,16Juw2gfa9IxEL3Vu69cH7,0,66,14,24,38,19,39,58,7,0.310779,0.356248,1670.711903,3,0.000997
Sebastian Yatra,Sebastian Yatra,,19625821,81,07YUOmWljBTXwIseAUd9TW,0,66,40,56,96,74,120,194,6,0.364559,0.422954,24700.358507,2,0.003239
Mariah Angeliq,Mariah Angeliq,,338519,70,0KKUc4amZyvswV2YL6WTar,0,66,31,28,59,37,36,73,6,0.326446,0.375253,2277.979402,0,0.002212
Nathy Peluso,Nathy Peluso,,901332,70,3VHAySZQPlfGlNLslzXYpN,0,66,6,4,10,8,4,12,7,0.277778,0.301058,197.967962,10,0.000827
Brray,Brray,,174287,70,1GKIlPFdcewHtpDVCQ8zmJ,0,66,79,27,106,150,43,193,7,0.314866,0.36402,4175.169386,0,0.006386
Alberto Stylee,Alberto Stylee,,298280,54,5mgqYTU6dhKlEdi7DOy4uU,0,66,13,16,29,28,36,64,7,0.296213,0.337586,1257.376848,3,0.001288
Alejo,Alejo,,22610,69,50sIhX3HytFEwQXZJLUZQE,0,66,9,7,16,10,7,17,6,0.293027,0.322616,187.7209,3,0.000905
Haze,Haze,,6497,55,77iZVjeYoYSl5P0K9mIiUE,0,66,6,7,13,9,9,18,7,0.291728,0.322333,16.176704,0,0.000578
Gloria Trevi,Gloria Trevi,,3733169,70,1Db5GsIoVWYktPoD2nnPZZ,0,66,13,16,29,17,20,37,7,0.303963,0.336215,4924.471925,6,0.001108
El Chombo,El Chombo,,99865,54,6iSZjc4kOoKZKiBXK5HbwD,0,66,1,2,3,9,18,27,7,0.260382,0.281555,0,6,0.000253
Antonio Orozco,Antonio Orozco,,1257679,63,1ADdpen72RPuafRcv0YRBf,0,66,9,12,21,18,23,41,6,0.315118,0.345865,7421.593134,6,0.000862
Paty Cantú,Paty Cantú,,2052805,63,7K9rdoOJSiKXoVXPlSkGKT,0,66,19,16,35,25,29,54,7,0.3214,0.357101,9892.22268,6,0.001847
CNCO,CNCO,,9040662,70,0eecdvMrqBftK0M1VKhaF4,0,66,12,9,21,15,11,26,7,0.298451,0.330362,1241.055481,6,0.001205
Andy Rivera,Andy Rivera,,2529656,66,7hIqJfRYGBWWT1Qxu6Cpd2,0,66,13,4,17,19,7,26,7,0.274974,0.303927,83.696487,0,0.001266
Alejandro Sanz,Alejandro Sanz,,6430416,75,5sUrlPAHlS9NEirDB8SEbF,0,66,19,20,39,40,27,67,7,0.317014,0.354075,5595.424963,6,0.001803
Carlos Vives,Carlos Vives,,5413142,74,4vhNDa5ycK0ST968ek7kRr,0,66,28,23,51,40,34,74,6,0.332492,0.372954,13866.768202,6,0.002565
Carlinhos Brown,Carlinhos Brown,,133595,51,5jvQoouPSDvUEwynz5KPpv,0,66,2,2,4,2,3,5,8,0.246106,0.261594,52.575036,6,0.000317
El Cata,El Cata,,8905,53,52aHqEQZ802daFzuMHfcES,0,66,8,3,11,18,3,21,7,0.246567,0.267492,156.040834,6,0.000685
Calle 13,Calle 13,,2724557,68,0yNSzH5nZmHzeE2xn6Xshb,0,66,6,9,15,8,10,18,7,0.267253,0.288505,3079.618877,6,0.001177
Gustavo Cerati,Gustavo Cerati,,3189693,68,1QOmebWGB6FdFtW7Bo3F0W,0,66,4,2,6,6,2,8,8,0.213283,0.22473,846.0942,6,0.000809
Pedro Capó,Pedro Capó,,1511985,68,4QVBYiagIaa6ZGSPMbybpy,0,66,23,13,36,38,16,54,7,0.318292,0.353514,6937.77172,6,0.002228
Tego Calderon,Tego Calderon,,3435632,69,3SUT1jjM5hzZj9TLfLZGIP,0,66,31,12,43,53,15,68,7,0.309561,0.342682,7377.850448,3,0.002535
Enrique Iglesias,Enrique Iglesias,,10863999,76,7qG3b048QCHVRO5Pv1T5lw,0,66,10,14,24,26,61,87,7,0.318548,0.359011,3070.235532,6,0.001063
Bizarrap,Bizarrap,,6319333,87,716NhGYqD1jl2wI1Qkgq36,0,66,34,21,55,51,26,77,6,0.307992,0.351878,9983.596488,10,0.003978
Alex Rose,Alex Rose,,3003742,70,2DspEsT7UXGKd2VaaedgG4,0,66,40,25,65,61,47,108,6,0.308956,0.355422,2091.024546,0,0.003069
Alexio,Alexio,,51861,55,4Tw0VaV1ENei24iQnktjXj,0,66,13,12,25,20,17,37,7,0.293353,0.33145,242.07665,0,0.000973
Jorge Celedón,Jorge Celedón,,1457991,60,7rNbdH4pgrnwguvzxhA2Ek,0,66,12,21,33,14,24,38,7,0.318548,0.354253,10266.154392,6,0.001003
Rosario,Rosario,,667825,63,05xSLrRgGwm2nCH2SmnNMW,0,66,8,12,20,11,17,28,7,0.312871,0.343029,4705.373108,6,0.000668
ELENA ROSE,ELENA ROSE,,14549,52,0zO8yNnw5GQgutcIyXfGBY,0,24,3,0,3,4,0,4,0,0,0,0,2,0.000388
Aitana,Aitana,,2143802,77,7eLcDZDYHXZCebtQmVFL25,0,66,12,18,30,20,25,45,7,0.315621,0.351278,4152.556504,2,0.001203
Alvaro Diaz,Alvaro Diaz,,199766,67,5J7rXWjtn5HzUkJ4Jet8Fr,0,66,19,21,40,28,30,58,6,0.321008,0.3627,4364.898344,2,0.00186
Guaynaa,Guaynaa,,727618,68,0BqURncJM5B1BBu7UM51eq,0,66,38,38,76,57,56,113,6,0.348632,0.399219,16789.088095,0,0.003504
Pablo Alborán,Pablo Alborán,,4506260,73,5M9Bb4adKAgrOFOhc05Y50,0,66,13,7,20,20,11,31,7,0.290548,0.317113,1575.166175,6,0.001415
Tommy Torres,Tommy Torres,,851711,61,264nbMzGPSkDZqTY8nXwCG,0,66,8,8,16,10,11,21,7,0.287796,0.316151,2379.778859,6,0.001377
Beret,Beret,,2629872,69,0ZHPrnImGh4re3TbSNkoZl,0,66,14,12,26,19,15,34,7,0.304549,0.336109,4374.883866,2,0.001393
Cali Y El Dandee,Cali Y El Dandee,,3640516,70,5DUlefCLzVRzNWaNURTFpK,0,66,25,31,56,48,60,108,6,0.335884,0.382553,4892.802197,2,0.001981
Emilia,Emilia,,845978,72,0AqlFI0tz2DsEoJlKSIiT9,0,66,16,18,34,23,25,48,6,0.324969,0.36289,5452.810279,10,0.001696
Mau y Ricky,Mau y Ricky,,5293018,73,2wkoKEfS6dXwThbyTnZWFU,0,66,33,37,70,48,52,100,6,0.347253,0.396287,7665.138339,6,0.002692
Danna Paola,Danna Paola,,3905733,72,5xSx2FM8mQnrfgM1QsHniB,0,66,14,21,35,22,30,52,6,0.323241,0.362658,5432.284444,2,0.001225
Morat,Morat,,6332470,81,5C4PDR4LnhZTbVnKWXuDKD,0,66,18,17,35,29,29,58,6,0.317907,0.352068,6217.143189,2,0.001667
Llane,Llane,,58065,56,7A02nc5WKMBLqSKXxGZ4o8,0,66,20,15,35,24,22,46,6,0.303963,0.341371,3947.806985,2,0.002011
Maná,Maná,,8281658,76,7okwEbXzyT2VffBmyQBWLz,0,66,3,2,5,3,2,5,7,0.247882,0.267438,273.630295,6,0.000369
TINI,TINI,,4704940,79,7vXDAI8JwjW531ouMGbfcp,0,66,17,21,38,21,31,52,6,0.328893,0.369367,2027.197522,2,0.001408
Juanes,Juanes,,3940375,73,0UWZUmn7sybxMCqrw9tGa7,0,66,19,14,33,39,25,64,7,0.315621,0.347565,7918.842596,6,0.002242
Yera,Yera,,56558,60,1vrahybrKylgwkjhbmOz94,0,66,21,22,43,40,37,77,6,0.324036,0.363924,3055.450323,2,0.001696
Alejandro Fernández,Alejandro Fernández,,5841495,75,6sq1yF0OZEWA4xoXVKW1L9,0,66,13,13,26,21,18,39,7,0.305137,0.336236,3662.352782,6,0.001207
Alejandra Guzman,Alejandra Guzman,,3030639,67,7Hf9AwMO37bSdxHb0FBGmO,0,66,7,6,13,16,12,28,7,0.292809,0.323906,1158.051162,6,0.0005
David Bisbal,David Bisbal,,4002152,70,5gOJTI4TusSENizxhcG7jB,0,66,21,20,41,33,37,70,7,0.326042,0.363514,6115.237434,6,0.002355
Joey Montana,Joey Montana,,2596478,64,3ATyg4fGC9F8trfb0GRWmX,0,66,17,23,40,25,42,67,6,0.331515,0.375696,5858.623347,2,0.001292
Alkilados,Alkilados,,1922269,56,2DP9xStkVVv753RBiEHXQB,0,66,6,6,12,8,6,14,8,0.279349,0.312072,2842.783419,0,0.00102
Paulo Londra,Paulo Londra,,17795379,79,3vQ0GE3mI0dAaxIMYe5g7z,0,66,5,6,11,5,9,14,7,0.282042,0.314445,53.551892,0,0.000681
Trebol Clan,Trebol Clan,,1409715,59,3YXpTiyVmYCfANOlnWv6vr,0,66,16,16,32,20,31,51,8,0.275453,0.313832,477.56411,3,0.001357
Ken-Y,Ken-Y,,316391,62,4DYFVNKZ1uixa6SQTvzQwJ,0,66,18,7,25,44,13,57,7,0.283968,0.317884,134.648788,3,0.001329
Don Chezina,Don Chezina,,329500,53,1ljNTY4uIBecRJmy69UNWt,0,66,10,4,14,19,6,25,7,0.248584,0.272414,53.088758,3,0.00072
D.OZi,D.OZi,,191421,50,7a9gFzWS5uEHtbNNgA6xyM,0,66,15,25,40,28,35,63,7,0.306202,0.352923,307.884602,0,0.001003
Anonimus,Anonimus,,265764,52,62lbdm09j0QUbWB7SqCJvt,0,66,29,39,68,42,76,118,6,0.322976,0.378797,1901.183338,0,0.002241
Tempo,Tempo,,859730,56,76whng5pl9msPkkjFUtWYn,0,66,22,19,41,31,22,53,7,0.307154,0.350319,633.835246,0,0.001609
C. Tangana,C. Tangana,,2105396,75,5TYxZTjIPqKM8K8NuP9woO,0,66,20,15,35,30,23,53,7,0.311514,0.348357,12386.390468,10,0.002673
Elvis Martinez,Elvis Martinez,,233556,50,66U02qGDesTqZImnLSiYeE,0,66,2,2,4,3,2,5,7,0.240341,0.258656,52.035854,6,0.000331
Frank Reyes,Frank Reyes,,546641,56,4vQV1LCGBdYAt5rIIPjSFZ,0,66,4,3,7,6,3,9,9,0.190178,0.201294,1140.708376,11,0.00117
El Chaval de la Bachata,El Chaval de la Bachata,,280570,53,4RnIr0AAau1SBJMbjJ9poC,0,37,2,2,4,3,3,6,2,0.75,0.833333,2,6,0.000695
Luis Vargas,Luis Vargas,,256365,53,6Mjbr8K3MiiRMqmFIB4zWq,0,36,5,1,6,9,1,10,1,1,1,534.501803,6,0.000955
Kiko Rodriguez,Kiko Rodriguez,,95719,50,1YYp1qwJ7EAitFINQ7gOKV,0,37,2,1,3,3,1,4,3,0.5,0.611111,0,6,0.000535
Raulin Rodriguez,Raulin Rodriguez,,367028,57,5rvaaWutd0gsbc2iMNo9k5,0,66,3,1,4,4,1,5,10,0.159822,0.166221,5.208609,6,0.000712
Teodoro Reyes,Teodoro Reyes,,224064,50,2ElpWA67jmhM6LrDav4Jcy,0,35,1,0,1,1,0,1,0,0,0,0,6,0.00024
Zacarias Ferreira,Zacarias Ferreira,,1254831,59,1LKPL2O3vA3ozNsmshDg3o,0,34,2,0,2,3,0,3,0,0,0,0,3,0.000331
Monchy & Alexandra,Monchy & Alexandra,,776750,60,3rs3EOlJ8jyPpdGiQ9Mhub,0,66,4,1,5,4,1,5,8,0.194821,0.205668,269.078801,6,0.000777
Juan Luis Guerra 4.40,Juan Luis Guerra 4.40,,3153793,73,3nlpTZci9O5W8RsNoNH559,0,66,15,5,20,24,9,33,7,0.275165,0.297652,3117.112428,6,0.001699
Julio Iglesias,Julio Iglesias,,2208102,67,4etuCZVdP8yiNPn4xf0ie5,0,66,3,7,10,6,7,13,7,0.271758,0.29569,665.534083,6,0.000387
Mala Rodríguez,Mala Rodríguez,,475818,58,3Ces1OJeGOVGcUB0wPaPXJ,0,66,12,11,23,22,14,36,6,0.298564,0.329409,8518.990073,6,0.001721
Alex Bueno,Alex Bueno,,215141,55,7esCoLcCoCK7FPa9casAH4,0,21,4,0,4,4,0,4,0,0,0,0,3,0.000996
Nicki Nicole,Nicki Nicole,,3108505,78,2UZIAOlrnyZmyzt1nuXr9y,0,66,22,25,47,27,35,62,6,0.324702,0.367447,14778.194089,10,0.002721
Ricardo Montaner,Ricardo Montaner,,5062946,68,4uoz4FUMvpeyGClFTTDBsD,0,66,7,9,16,10,15,25,6,0.30303,0.335464,1197.117857,6,0.000948
India Martinez,India Martinez,,801879,62,6FOpWOxsjQxKEbLiJpU1xV,0,66,20,14,34,27,17,44,7,0.302219,0.335741,4801.010332,6,0.001989
Mozart La Para,Mozart La Para,,372690,56,0odliLZMTk45CEVzF3Zocl,0,66,21,14,35,27,16,43,6,0.300838,0.338143,1980.424022,13,0.001915
Voltio,Voltio,,727927,55,3Okcq0dqLVlEFHRZ5t22bA,0,66,20,6,26,24,8,32,7,0.274592,0.303749,1135.094066,3,0.001881
José Feliciano,José Feliciano,,297443,62,7K78lVZ8XzkjfRSI7570FF,0,66,8,4,12,13,7,20,8,0.262808,0.283645,3855.433934,6,0.000773
Jadiel,Jadiel,,1081012,52,1K0lOPFlbPF3Volp5qIYNw,0,66,4,3,7,5,4,9,7,0.267253,0.297146,34.439769,0,0.000405
Kiko el Crazy,Kiko el Crazy,,81845,58,3NpG6SsHaQETkdQVZH6V1E,0,66,34,15,49,51,26,77,7,0.293462,0.335256,2211.188066,0,0.003581
Joyce Santana,Joyce Santana,,90770,55,4zOhMWD0LoBe2nP7s9cHhX,0,66,22,16,38,31,26,57,7,0.297776,0.338514,766.617682,0,0.002166
Jamby El Favo,Jamby El Favo,,807287,64,128ftF9X7Kd7Di2fq3wYVs,0,66,17,9,26,25,12,37,7,0.278561,0.31261,606.722809,0,0.001625
Lirico En La Casa,Lirico En La Casa,,192139,58,1Vr7DTbtTpOp4tn4hAGOYo,0,66,10,7,17,13,8,21,8,0.241148,0.263944,752.718532,13,0.00115
Ceky Viciny,Ceky Viciny,,136475,53,5UopXhshFFqRIMfeZrBclq,0,66,15,15,30,38,40,78,7,0.264834,0.300313,730.309527,13,0.002682
Ankhal,Ankhal,,128445,59,6NmMI7UnfmIpLRYoz8H9jm,0,66,13,17,30,16,23,39,6,0.305019,0.346983,186.626652,0,0.001175
Nino Freestyle,Nino Freestyle,,115708,50,1AACxWCwNIa3ecOBQJnXRV,0,66,12,14,26,14,16,30,7,0.284787,0.32431,685.368435,13,0.001403
Milly,Milly,,44144,53,7kXCcNRLEnblbTAppPraBp,0,66,10,20,30,15,44,59,7,0.293135,0.33632,83.102869,0,0.000902
Hozwal,Hozwal,,89748,50,1lgtR3WlcFxEy6yPoOh0J2,0,66,26,17,43,31,21,52,7,0.295327,0.336278,1185.754692,0,0.002415
Alex Gargolas,Alex Gargolas,,55155,59,7awyvLSthqOcL5A3hnR1pf,0,66,9,39,48,12,90,102,7,0.331515,0.385898,1238.329634,3,0.000854
Bad Gyal,Bad Gyal,,759986,68,4F4pp8NUW08JuXwnoxglpN,0,66,8,10,18,9,12,21,7,0.291621,0.327725,951.708888,10,0.000855
Eix,Eix,,31219,58,384MqcXCGGFh9UcjI5Tpc5,0,66,19,19,38,23,22,45,7,0.294996,0.337016,606.133858,0,0.002057
Lil Geniuz,Lil Geniuz,,14159,50,7nuTWfojdN0o8d7NGDo71U,0,66,3,7,10,3,9,12,7,0.271664,0.302462,18.450847,0,0.000409
Lola Indigo,Lola Indigo,,779318,68,3bvfu2KAve4lPHrhEFDZna,0,66,19,25,44,23,38,61,6,0.328756,0.372764,5328.770408,2,0.00172
Leebrian,Leebrian,,30201,53,40lro6xpFS9TxV2uC7yvs4,0,66,8,18,26,9,25,34,7,0.304197,0.34613,314.574986,0,0.000889
Cauty,Cauty,,857812,59,2QUvtLq6oQaX0LNsYY2fas,0,66,27,24,51,37,33,70,6,0.307273,0.35403,1678.460296,0,0.001968
Don Patricio,Don Patricio,,586161,59,6vPXtLmNd3mW0dd1Rb9eQ9,0,66,8,11,19,12,12,24,7,0.287482,0.323345,3339.866979,10,0.001013
Rafa Pabön,Rafa Pabön,,210903,67,11YLRSsZA3YVuQQtHXKTlz,0,66,42,18,60,61,30,91,7,0.297216,0.339542,2654.021778,0,0.00348
Nekxum,Nekxum,,1905,54,4gZwJrNP5NG3KGS2dRcS5c,0,66,4,4,8,14,15,29,7,0.267343,0.295542,3.302106,2,0.000465
Javiielo,Javiielo,,251108,62,3HH6yOn1yJNZo3RY5zEfy5,0,66,15,15,30,31,30,61,7,0.275934,0.315217,566.717859,2,0.001258
Thalia,Thalia,,4072132,69,23wEWD21D4TPYiJugoXmYb,0,66,8,23,31,10,44,54,6,0.335314,0.376709,4486.053375,6,0.00087
Sofía Reyes,Sofía Reyes,,2576624,72,0haZhu4fFKt0Ag94kZDiz2,0,66,14,13,27,19,17,36,7,0.312253,0.349253,2875.748943,6,0.001507
Cartel De Santa,Cartel De Santa,,11380611,75,07PdYoE4jVRF6Ut40GgVSP,0,67,3,5,8,4,15,19,8,0.243932,0.261882,2378,1,0.001206
Millonario,Millonario,,1203836,65,2N2aJ1SXQxMkhHD8C6fhYD,0,67,2,1,3,9,1,10,9,0.196146,0.205034,0,1,0.000577
Santa Estilo,Santa Estilo,,344374,54,59XuCTeNNS0fVgBrFoPNfG,0,67,1,2,3,1,2,3,9,0.196195,0.205664,0,1,0.000405
Millonario & W. Corona,Millonario & W. Corona,,734860,59,31l8FA2bO5qxpqf8uhV5eZ,0,67,1,1,2,3,2,5,9,0.196146,0.205034,0,1,0.000405
Gigolo Y La Exce,Gigolo Y La Exce,,474749,62,7lCRuW6BSXGAsxuQV9lR0i,0,66,21,21,42,36,37,73,7,0.297664,0.340678,177.490399,0,0.001761
Rich Music LTD,Rich Music LTD,,229079,63,2kqUKsTuEj1lPbm6BSn1AU,0,66,3,15,18,11,39,50,7,0.305491,0.345814,2.845725,0,0.000395
ChocQuibTown,ChocQuibTown,,615931,56,6tkyhGe9hGI3Lcfo4gVh6Z,0,66,8,17,25,16,26,42,6,0.318164,0.358692,1108.150995,6,0.000808
Descemer Bueno,Descemer Bueno,,42726,64,5luyt0SUvGkDMY4ILP6Qhl,0,66,10,6,16,25,8,33,7,0.27507,0.296682,1432.298268,6,0.000886
Gente De Zona,Gente De Zona,,1469252,70,2cy1zPcrFcXAJTP0APWewL,0,66,18,23,41,38,34,72,6,0.327529,0.367405,4941.590763,6,0.001765
Marco Antonio Solís,Marco Antonio Solís,,5385264,73,3tJnB0s6c3oXPq1SCCavnd,0,66,13,1,14,23,1,24,8,0.238311,0.254699,447.313324,6,0.001533
Juan Magán,Juan Magán,,1690012,68,1ackd5XprZEkH3McKbQD51,0,66,29,44,73,50,74,124,6,0.355696,0.407342,18223.558543,6,0.002242
Laura Pausini,Laura Pausini,,2069787,69,2e4nwiX8ZCU09LGLOpeqTH,0,66,8,3,11,13,9,22,7,0.275165,0.295479,419.20415,6,0.000819
Aleks Syntek,Aleks Syntek,,1250900,65,0r8toju2ecKaVtItkzAnNi,0,66,11,12,23,16,17,33,7,0.281139,0.309256,5554.709378,6,0.001465
Noel Schajris,Noel Schajris,,986308,56,2uEjXyVi0SA1HPpj3zquXh,0,66,14,6,20,21,7,28,7,0.292376,0.318324,925.841535,6,0.000962
KURT,KURT,,240408,62,4kcnsS1aAB40FMcLD01gmI,0,66,7,10,17,9,20,29,7,0.283459,0.308611,4014.587932,6,0.000778
Víctor Manuelle,Víctor Manuelle,,1451981,63,4N5fp4zhTsVITZTVfsXpc2,0,66,17,17,34,25,24,49,7,0.324569,0.363282,4676.567554,6,0.001488
Sael,Sael,,28329,59,6Itjwvv5YmsC8ZcI5N4Jux,0,66,12,19,31,14,20,34,7,0.305728,0.347966,4301.502407,2,0.001314
Abraham Mateo,Abraham Mateo,,1405046,63,2bxxlINUlcMQQb39K7IopR,0,66,14,15,29,15,21,36,7,0.307752,0.345244,1755.36536,6,0.001309
Belinda,Belinda,,1483278,70,5LeiVcEnsZcwc133TUhJNW,0,66,15,9,24,26,18,44,6,0.311883,0.341709,2213.782188,6,0.001263
Ricardo Arjona,Ricardo Arjona,,9548021,75,0h1zs4CTlU9D2QtgPxptUD,0,66,2,6,8,5,11,16,7,0.269533,0.290711,190.390877,6,0.000426
Gaby Moreno,Gaby Moreno,,71506,58,0K9pSmFx0kWESA9jqx8aCW,0,66,4,1,5,9,1,10,8,0.223543,0.236005,197.931784,6,0.000734
Kany García,Kany García,,1621175,69,69UypehHabb68utzfjAVlV,0,66,14,20,34,17,23,40,6,0.3214,0.356983,9607.180292,6,0.00147
Mijares,Mijares,,1643074,66,3zhijRRIZX2B6G2T7vJl9p,0,66,11,10,21,17,26,43,7,0.26064,0.286124,1414.071385,6,0.000946
Don Miguelo,Don Miguelo,,211409,56,1noWnd8QFQD9VLxWEeo4Zf,0,66,9,11,20,10,12,22,7,0.276611,0.312827,790.249758,13,0.00111
Trina,Trina,,925995,55,4PrinKSrmILmo0kERG0Ogn,0,66,1,1,2,3,1,4,8,0.238743,0.256151,0,6,0.000311
Toby Love,Toby Love,,580223,52,72R3RMGmSmzG57R7OUaDaN,0,66,5,9,14,8,13,21,7,0.282951,0.312061,491.335541,3,0.000462
Ovy On The Drums,Ovy On The Drums,,161215,70,3m5qlPf2OkihLz3dRYnkPA,0,66,11,14,25,15,16,31,7,0.299129,0.335814,486.265915,2,0.000988
Micro TDH,Micro TDH,,1307751,67,1aWJsBQa67l72j1VT3D6Ow,0,66,13,11,24,23,24,47,6,0.297104,0.331266,1781.590429,2,0.001562
FABRO,FABRO,,6762,52,64CJy4LTJjFj7lcDxTECn2,0,66,5,5,10,5,6,11,7,0.262633,0.285383,174.607577,10,0.000638
MYA,MYA,,472464,62,5Rj6rNR8zIlUUDCs1OyPmW,0,66,13,18,31,15,30,45,7,0.308956,0.346531,7357.791192,10,0.001413
YOVNGCHIMI,YOVNGCHIMI,,31719,55,4aSlfXDn9R60UlbZEboBUy,0,66,7,4,11,8,4,12,7,0.257917,0.28421,17.606207,0,0.000912
Corina Smith,Corina Smith,,142821,53,7mXfsy3lF4kU0f2KTNKSr8,0,66,9,13,22,10,16,26,6,0.298903,0.336308,184.721927,0,0.000879
Chucky73,Chucky73,,137291,60,38epWdyauFwdRkldqUMfWE,0,66,19,15,34,21,16,37,7,0.286232,0.325847,2216.477322,0,0.00253
Maikel Delacalle,Maikel Delacalle,,400346,61,2t7vyRN71qtQT18frElAnV,0,66,19,21,40,22,26,48,6,0.307752,0.35097,7452.420122,10,0.002232
Fonseca,Fonseca,,2361061,67,53KTldaJ8tHSkYU3nigfwP,0,66,13,16,29,17,29,46,7,0.304784,0.340488,7295.162353,6,0.001093
Mario Bautista,Mario Bautista,,1642207,59,0AspLZGQkP38yddNoD0pLn,0,66,7,8,15,8,13,21,6,0.294996,0.326371,237.419418,2,0.000755
Chimbala,Chimbala,,435273,67,4VVEpEhC8NcR7AqNEds42U,0,66,27,13,40,38,16,54,7,0.28906,0.327345,1011.603531,13,0.002839
"Franco ""El Gorilla""","Franco ""El Gorilla""",,276050,58,2biH2I1TvZlIIIc5W14oIJ,0,66,26,18,44,57,27,84,7,0.301757,0.345479,2794.79227,3,0.00208
Axel,Axel,,1323631,57,32x1uogH2zajP85pzZAtuE,0,66,6,7,13,7,11,18,7,0.278071,0.303761,2203.397978,6,0.000789
Franco De Vita,Franco De Vita,,4095541,68,4NEYQeEYBUjfaXgDQGvFvu,0,66,13,18,31,18,22,40,7,0.31638,0.354222,7456.477205,6,0.00097
Juan Gabriel,Juan Gabriel,,6791318,73,2MRBDr0crHWE5JwPceFncq,0,66,10,25,35,17,36,53,7,0.328482,0.370024,8649.360671,6,0.001048
LA INDIA,LA INDIA,,766387,57,3NIZFmehJM8YiGpCdihlck,0,66,6,5,11,6,12,18,8,0.273356,0.294995,4167.298748,6,0.00118
Redimi2,Redimi2,,1822557,63,0WZOmdnCln6FK6GM9e2tGm,0,66,12,16,28,42,44,86,8,0.25451,0.285873,13134.968985,8,0.001564
John Eric,John Eric,,64537,58,0IUvQ8DrCymt5IHywZsda2,0,66,9,5,14,10,5,15,7,0.264834,0.291745,69.492996,3,0.000831
Hector & Tito,Hector & Tito,,689768,58,5aB4SpKYteOJ8pAleoKkg7,0,66,9,5,14,14,7,21,7,0.27402,0.298478,234.061999,3,0.000597
Maite Perroni,Maite Perroni,,1141894,68,6ModsWtBph2rE6zCTVxvZt,0,66,8,8,16,30,14,44,7,0.299242,0.332007,1015.162933,7,0.000698
Sin Bandera,Sin Bandera,,4858017,69,7xeM7V59cA1X8GKyKKQV87,0,66,6,4,10,8,5,13,7,0.268707,0.293086,625.071552,6,0.000663
Andrés Cepeda,Andrés Cepeda,,2474747,63,49Z1AvGeUaBSanPaOmplK6,0,66,14,10,24,25,10,35,7,0.301872,0.330995,3810.503277,6,0.001372
Omar Montes,Omar Montes,,435747,70,3lY9Fxceu60W1rbon7PkuF,0,66,27,14,41,39,16,55,7,0.30303,0.338535,6883.155238,10,0.002813
Ana Mena,Ana Mena,,498723,70,6k8mwkKJKKjBILo7ypBspl,0,66,12,14,26,14,15,29,6,0.313866,0.346624,4676.585376,6,0.00109
Dvicio,Dvicio,,1039932,61,2KxjMGXFgX1vt9grpbD3xI,0,66,6,10,16,7,21,28,7,0.291621,0.319611,270.6438,6,0.000784
Foreign Teck,Foreign Teck,,7510,53,12lHTAdc9T204lw5qPtasv,0,66,4,6,10,4,7,11,7,0.27768,0.308885,1.774008,0,0.000517
Mike Bahía,Mike Bahía,,2617727,66,1phfTBIocBW3UwqcYjaEN6,0,66,14,19,33,24,30,54,7,0.31213,0.351573,2645.852875,2,0.001272
DaniLeigh,DaniLeigh,,1014196,61,0XIKGBo9PnK1ApI5tZA60d,0,66,3,3,6,4,4,8,7,0.269349,0.296133,41.589058,0,0.000496
Chanell,Chanell,,19513,52,5cDfQlhT80II3f2ECXm6oA,0,66,4,7,11,5,9,14,7,0.271945,0.301522,8.584822,0,0.000503
Orishas,Orishas,,422498,55,2gKYxTUOqw9aPt7ljMwSHT,0,66,7,8,15,8,9,17,7,0.290548,0.317438,1120.501487,6,0.000807
Rocío Dúrcal,Rocío Dúrcal,,3202048,68,2uyweLa0mvPZH6eRzDddeB,0,66,3,20,23,8,35,43,7,0.296769,0.333159,1816.554075,6,0.000344
Andrés Calamaro,Andrés Calamaro,,1997190,68,3tAICgiSR5PfYY4B8qsoAU,0,66,17,16,33,24,32,56,7,0.30632,0.338704,17297.448588,6,0.002492
María José,María José,,2022376,68,1dJyh390MvfYPuNbhnbSDs,0,66,15,24,39,27,30,57,7,0.311391,0.351703,8083.227339,6,0.001166
Ana Gabriel,Ana Gabriel,,3115386,69,41ESHLayJ5sDKjAOv6cMhe,0,11,3,0,3,8,0,8,0,0,0,0,6,0.001088
José José,José José,,5113031,73,4mN0qcMxWX8oToqfDPM5yV,0,66,5,22,27,10,28,38,8,0.294776,0.334583,2739.310381,6,0.000677
José Maria Napoleón,José Maria Napoleón,,861944,60,72v53CufRiSyqcQ78KUQ5p,0,66,2,3,5,4,10,14,7,0.263773,0.284183,55.200658,6,0.000305
Emmanuel,Emmanuel,,2201565,66,2DmYtFBKcxb3ajwWWgA576,0,66,8,7,15,11,9,20,7,0.290869,0.315374,3594.497671,6,0.000845
Natalia Lafourcade,Natalia Lafourcade,,3438843,72,1hcdI2N1023RvSwLzTtdsp,0,66,21,16,37,31,26,57,7,0.291944,0.324732,13482.935032,6,0.002329
Luny Tunes,Luny Tunes,,1370179,60,5pZE9tgrhmIGWAsJZ7YxNK,0,66,8,18,26,29,38,67,7,0.299469,0.339539,1336.653541,3,0.000733
Paloma Mami,Paloma Mami,,1044393,72,7rOlQwf8OuFLFQp4aydjBt,0,66,3,2,5,3,2,5,7,0.252558,0.269879,125.165557,10,0.000599
Ha*Ash,Ha*Ash,,6683404,72,5xd2Tg7Zo8755eCy8Gxkp8,0,66,11,9,20,15,10,25,7,0.299016,0.330184,2954.16389,6,0.001027
Miguel Bosé,Miguel Bosé,,2127467,68,7mWCSSOYqm4E9mB7V4ot6S,0,66,9,23,32,12,40,52,7,0.300266,0.338095,5527.904943,6,0.001464
Matisse,Matisse,,855615,69,77aLk6J8ofnVxa1eXK9jiU,0,66,13,10,23,15,11,26,7,0.290655,0.321151,3046.978209,6,0.001848
Río Roma,Río Roma,,2453373,68,2O3v9rCTzLhPFaGaAVgZLt,0,66,7,18,25,7,24,31,7,0.318805,0.357357,1604.216421,6,0.000537
Kalimba,Kalimba,,1802473,60,4RjamFQJNT8nVbTKXJDJgv,0,66,7,8,15,9,10,19,7,0.300152,0.327281,1955.859062,6,0.000601
Jerry Di,Jerry Di,,248939,62,7f02bxFbZIOVdSbYRNYvLT,0,66,21,20,41,28,35,63,6,0.312253,0.353038,1653.23035,0,0.001835
Danny Ocean,Danny Ocean,,4223513,78,5H1nN1SzW0qNeUEZvuXjAj,0,66,9,10,19,10,14,24,6,0.297328,0.331245,322.4672,0,0.000889
Bulova,Bulova,,131962,50,6NAhbfEqeWELwfjH391Vz0,0,66,16,13,29,23,16,39,7,0.296769,0.333767,2211.66477,13,0.002687
Darkiel,Darkiel,,1041470,63,4z19QMyPVRwbd4Fs2LisBa,0,66,26,19,45,48,36,84,7,0.303147,0.345329,1238.251761,0,0.002045
Jesse & Joy,Jesse & Joy,,6506624,73,1mX1TWKpNxDSAH16LgDfiR,0,66,8,9,17,9,11,20,7,0.287796,0.316944,723.085319,6,0.001134
Vanesa Martín,Vanesa Martín,,961343,64,5kSJMVPcTITrSZxTrHllVN,0,66,17,9,26,23,13,36,7,0.266532,0.290407,2492.180007,6,0.001861
Quevedo,Quevedo,,349982,84,52iwsT98xCoGgiGntTiR7K,0,66,7,8,15,11,8,19,7,0.287901,0.320687,1977.806717,10,0.000977
Ak4:20,Ak4:20,,505243,67,1SiLK8gdECx2iEm2SSj0Bl,0,66,4,3,7,4,3,7,8,0.2528,0.278317,75.11239,10,0.000716
Rels B,Rels B,,3897937,78,2IMZYfNi21MGqxopj9fWx8,0,66,11,15,26,13,18,31,7,0.303147,0.342544,3710.32147,10,0.001344
Asan,Asan,,105818,58,6Nl4VXcX86fBMO4YE6oYfN,0,66,10,10,20,18,14,32,7,0.269257,0.299319,578.920209,10,0.001306
Lara91k,Lara91k,,30553,50,2zPvDg6LI6NHPQVQIESjfW,0,66,5,5,10,7,6,13,7,0.256911,0.282622,1564.59889,10,0.000724
YSY A,YSY A,,1057643,70,2qWK8K2Jfh67UqtwY8tCW6,0,66,9,12,21,16,19,35,7,0.265725,0.2994,1073.023012,10,0.001008
Rei,Rei,,151782,68,4IG1SDlwgNKzqTmjBrvY3K,0,66,10,10,20,15,15,30,7,0.268434,0.300952,892.698562,10,0.001063
Lucho SSJ,Lucho SSJ,,295253,59,1OBizG9nrnHJkrL9NjnWYN,0,66,10,14,24,11,24,35,7,0.270178,0.304786,2340.890049,10,0.001663
Obie Wanshot,Obie Wanshot,,27531,54,48vP5SxlTO6yOI7SLKIOQV,0,66,6,5,11,10,9,19,7,0.260554,0.288074,30.056489,10,0.000675
Neo Pistea,Neo Pistea,,979798,62,01m2XZ7m7rAz6KY3scTdaV,0,66,18,27,45,29,46,75,7,0.310413,0.357333,5749.212382,10,0.001712
Julianno Sosa,Julianno Sosa,,217372,69,4IC2X34tZmHG3VfTbpzvwL,0,66,7,5,12,17,12,29,8,0.23359,0.25467,1149.477457,10,0.001603
Young Cister,Young Cister,,198675,68,0Yg29FX1M4ayqjXs0ttZFq,0,66,7,10,17,11,18,29,7,0.261071,0.29374,563.420898,10,0.001029
Tobi,Tobi,,132698,52,6H70hylNqfc86Omz8GoyDB,0,66,8,6,14,9,8,17,7,0.246567,0.269578,692.092618,10,0.001025
Mesita,Mesita,,197858,61,2IKdK6PbitvCiXt1t2bPU6,0,66,4,10,14,8,19,27,7,0.264126,0.295118,1964.133467,10,0.000878
CA7RIEL,CA7RIEL,,149097,54,348pk4o3EhKmsSahzuClSf,0,66,5,3,8,13,11,24,7,0.256078,0.279274,471.768104,10,0.000672
Kidd Keo,Kidd Keo,,2234672,69,0VZrPa7mWAYXH4CwmYk8Km,0,66,4,5,9,12,22,34,7,0.254757,0.277562,3752.646356,4,0.001307
Marcianos Crew,Marcianos Crew,,162361,52,0Hkx0YcHHxDRRbH9WsSW0I,0,66,3,6,9,3,13,16,7,0.256161,0.282315,324.6219,10,0.000424
Dani Ribba,Dani Ribba,,340502,61,6cC67GpmPCjQjOYLpmOGhN,0,66,5,7,12,6,8,14,7,0.265725,0.294497,42.592877,10,0.000688
FMK,FMK,,900900,70,0dUyjgCyjfj5eMx6bX2TWf,0,66,19,18,37,32,35,67,7,0.304784,0.34305,8184.989944,10,0.0023
C.R.O,C.R.O,,985688,70,4puAp107dCehraE47QXVQX,0,66,15,14,29,37,21,58,7,0.271105,0.30629,3787.012201,10,0.001799
Moonkey,Moonkey,,85985,51,3qiQUUvazYmo7tBgQeb2rf,0,66,4,10,14,4,13,17,7,0.279646,0.311923,750.561418,10,0.000585
Dani Martín,Dani Martín,,773876,63,3AIPhNgeF9S1Kyg9Yy3UQW,0,66,14,9,23,21,15,36,7,0.283053,0.309774,3856.11459,6,0.001438
Manuel Carrasco,Manuel Carrasco,,1866267,64,7qAoXV4U0qDxQAUqhszjAA,0,66,7,4,11,10,7,17,8,0.251592,0.269986,194.312217,6,0.000991
Malú,Malú,,1525791,61,3TLGNOdp1UWYMnV5XG9HkR,0,66,12,13,25,13,22,35,7,0.282244,0.310838,2610.926574,6,0.001543
Armando Manzanero,Armando Manzanero,,615242,56,5lODCkFdEtpPn3YxfmyLfT,0,13,10,1,11,14,1,15,1,1,1,192.031786,6,0.000891
Greeicy,Greeicy,,5703186,69,5dbaLmK5SHLLg8Z4CcTJpX,0,66,20,24,44,35,39,74,6,0.335599,0.376941,5491.417211,2,0.002077
Chayanne,Chayanne,,6376417,70,1JbemQ1fPt2YmSLjAFhPBv,0,66,1,1,2,1,1,2,7,0.263333,0.286272,42.988643,6,0.000232
Cami,Cami,,739843,64,3VCrybIJKH7UurbDcZbMmn,0,66,3,5,8,6,11,17,7,0.256994,0.274129,1354.702061,2,0.000695
Paulina Rubio,Paulina Rubio,,2402107,66,1d6dwipPrsFSJVmFTTdFSS,0,66,7,6,13,11,19,30,7,0.294776,0.324708,1123.624342,6,0.000594
Alvaro Soler,Alvaro Soler,,1600011,70,2urF8dgLVfDjunO0pcHUEe,0,66,6,6,12,8,9,17,7,0.288637,0.313885,236.257045,2,0.000743
Mocedades,Mocedades,,565338,55,4Sm7JCttzWMwHJtb3UJ8SY,0,66,7,9,16,13,15,28,7,0.276902,0.30126,2019.902372,6,0.000736
Antonio José,Antonio José,,481639,61,1dbp04JzZ81JXlMGupCnJ8,0,66,8,10,18,11,17,28,7,0.306083,0.335573,1308.835377,2,0.000809
Bacilos,Bacilos,,1493927,66,1mux8L6xg2Cmrc7k0wQczl,0,66,1,2,3,1,4,5,7,0.262371,0.279982,3.365881,2,0.000283
"Héctor Acosta ""El Torito""","Héctor Acosta ""El Torito""",,688126,57,4TCAAIMmeZXCTVlHUsicOn,0,66,5,8,13,6,15,21,7,0.288216,0.317061,568.437757,3,0.000467
Bhavi,Bhavi,,944752,65,7fT2Me47PQ8T7954PKrcwR,0,66,17,18,35,25,33,58,7,0.28448,0.321745,4016.520953,10,0.002013
Ptazeta,Ptazeta,,109606,64,5UN0rzL594mWY2RbOtZqIN,0,66,10,8,18,10,8,18,7,0.286025,0.312312,4046.164216,10,0.001261
Snow Tha Product,Snow Tha Product,,531490,63,3p3jPcp8b7WL9XYj4xlsWj,0,66,9,4,13,12,4,16,7,0.256494,0.282758,558.702989,2,0.001048
Dread Mar I,Dread Mar I,,2297351,69,1aw0Cdl1DIrtUrUA6fGbAR,0,66,5,3,8,6,3,9,7,0.27421,0.294442,459.213972,10,0.000659
ACRU,ACRU,,291986,50,0bYQe0JDIjxkSHQoXlfngl,0,66,3,3,6,3,3,6,7,0.238311,0.258734,43.705061,10,0.000592
LIT killah,LIT killah,,3675571,74,1vqR17Iv8VFdzure1TAXEq,0,66,13,18,31,27,33,60,6,0.30632,0.346224,1865.186381,10,0.001356
Sammy & Falsetto,Sammy & Falsetto,,310705,51,6AT27ojKlBuZToFIGwQZDc,0,66,4,12,16,5,16,21,7,0.286647,0.324876,44.494649,0,0.000343
Jeeiph,Jeeiph,,197269,53,6ZtLRqHEkAXPWVw0eRbDac,0,66,9,9,18,10,20,30,7,0.280639,0.314192,186.15389,0,0.000849
Big Soto,Big Soto,,794828,66,2TQ4CGgxxCWHqa9yYIGDoU,0,66,27,25,52,62,50,112,6,0.320747,0.367342,10535.855796,2,0.002661
Lali,Lali,,1361280,66,22P1OY4TRFRwhP0q29loQ8,0,66,9,8,17,14,13,27,6,0.296324,0.325802,2928.42725,6,0.001164
Jd Pantoja,Jd Pantoja,,3292225,57,7yjRUA0Iz3VI4Kqa5oPJZK,0,66,9,6,15,12,8,20,7,0.270178,0.300048,179.869879,0,0.000955
Rubén Blades,Rubén Blades,,1188323,62,5BwMgvRwlq61SmknvsVIQj,0,17,10,0,10,12,0,12,0,0,0,0,6,0.001537
Gilberto Santa Rosa,Gilberto Santa Rosa,,2138315,67,27vNK840zYq6IfDijHPsv1,0,66,17,12,29,27,19,46,7,0.277778,0.303095,5532.769019,6,0.001381
Lele Pons,Lele Pons,,1108371,61,6i3DxIlAqnDkwELLw4aVrx,0,66,7,8,15,9,8,17,6,0.295327,0.328882,182.492458,0,0.00067
Jerry Rivera,Jerry Rivera,,1403781,64,7wOZy3KdFVVINgNFFxkxwO,0,42,3,0,3,5,0,5,0,0,0,0,6,0.000392
Gloria Estefan,Gloria Estefan,,626644,64,5IFCkqu9J6xdWeYMk5I889,0,66,2,6,8,5,8,13,8,0.258339,0.279427,4050.296903,6,0.000346
Amaia Montero,Amaia Montero,,1025631,57,4LbuSjHhhAddvN44qXpRJo,0,66,7,1,8,12,1,13,8,0.21975,0.230731,156.907904,6,0.000691
Luciano Pereyra,Luciano Pereyra,,1827739,63,6ZZ2DeepA3GpoGU4KwqSlU,0,66,7,11,18,9,18,27,7,0.301412,0.330995,4065.280217,6,0.001033
Mon Laferte,Mon Laferte,,4673827,71,4boI7bJtmB1L3b1cuL75Zr,0,66,15,9,24,22,14,36,7,0.297552,0.324738,7808.162275,6,0.002434
Cultura Profética,Cultura Profética,,1624990,63,65HuWBUC1d8ty1q6J42Nfi,0,66,3,1,4,4,1,5,7,0.251352,0.267104,162.655488,2,0.000557
Nelly Furtado,Nelly Furtado,,3237874,74,2jw70GZXlAI8QzWeY2bgRc,0,66,3,8,11,8,18,26,7,0.281841,0.306902,370.702335,6,0.000529
Fito Paez,Fito Paez,,1289893,63,1bZNv4q3OxYq7mmnLha7Tu,0,66,10,5,15,16,7,23,7,0.260812,0.280048,3594.603107,6,0.001229
El Búho,El Búho,,113245,51,1I7FVmvisCtSFzmm87mbLR,0,32,2,1,3,2,1,3,1,1,1,785,6,0.000519
Fanny Lu,Fanny Lu,,846702,58,6GRC8segVAr34gm6pjfSoQ,0,66,8,9,17,10,11,21,7,0.293353,0.324066,8702.951337,3,0.001042
Yuri,Yuri,,1922303,64,4OgNARLQSC4yy7Dsa5cqxx,0,66,15,22,37,24,34,58,7,0.312747,0.354033,6764.964711,6,0.002883
Lérica,Lérica,,68520,61,4d3kmfoZBTuUPSUjgP45uo,0,66,15,15,30,20,24,44,6,0.315118,0.351603,1960.931651,6,0.001335
Polimá Westcoast,Polimá Westcoast,,261294,77,768O5GliF0bqscyghggrbE,0,66,19,12,31,36,17,53,7,0.288637,0.323683,4727.333015,10,0.002779
vf7,vf7,,52996,53,6bxjoq64Y0HTfMc4GIbpyJ,0,66,6,11,17,7,16,23,6,0.288006,0.323186,188.366145,0,0.000658
Juanfran,Juanfran,,124339,53,7zY0DMisq1oYXvNNgGwHBY,0,66,5,8,13,6,9,15,7,0.275645,0.305901,104.333911,0,0.000686
Ecko,Ecko,,992787,62,2Jb9jVnCpWkXtoGznFJ6bF,0,66,16,15,31,21,22,43,7,0.292593,0.331248,4637.886083,10,0.001487
Pepe Aguilar,Pepe Aguilar,,3677951,69,03Yb3iBy9GCifXiATEFcit,0,66,8,4,12,11,4,15,8,0.247107,0.267307,1339.295402,6,0.001342
Lila Downs,Lila Downs,,375336,58,3mXI2gpwWnNO9qbQG3n3EP,0,66,14,11,25,17,16,33,7,0.280939,0.30934,4970.156052,6,0.001456
Pedro Fernández,Pedro Fernández,,1653607,59,24dYJ8P3YuFihvMcElFUWh,0,66,6,1,7,11,2,13,8,0.246183,0.260978,175.372138,6,0.000516
Reyli Barba,Reyli Barba,,1505831,63,69BUYvpG9MbjCyIZfsFdhJ,0,66,14,14,28,22,14,36,8,0.273356,0.30332,9224.530964,6,0.001399
Daniela Romo,Daniela Romo,,841129,58,6gvh8pQI316iafbHiT7B3y,0,66,3,8,11,8,10,18,8,0.258086,0.282835,145.357605,6,0.00035
Leonel García,Leonel García,,657565,63,3t7UqWteBBmHXkcVhMSyay,0,66,23,20,43,34,30,64,7,0.30408,0.339467,10418.053445,6,0.002086
Pandora,Pandora,,268876,58,44nb9BaqV2jVvxKCaXHwlP,0,66,9,10,19,16,14,30,7,0.287273,0.315585,1655.008455,6,0.000669
Gian Marco,Gian Marco,,1169459,61,2gDqGAadPIPiA7LtmNn74g,0,66,9,6,15,11,7,18,7,0.270363,0.294943,1180.32054,6,0.000697
Edith Márquez,Edith Márquez,,1065516,61,7afXSXOa8dE3c2C5XIguAv,0,66,9,4,13,11,4,15,8,0.255333,0.272771,274.012341,6,0.000708
Francisco Céspedes,Francisco Céspedes,,213088,53,54jti4nqabEAlBvIDU2zt8,0,27,4,0,4,5,0,5,0,0,0,0,6,0.000358
DEKKO,DEKKO,,370078,68,6ZvYYrrfpb1Z7kICDyxWQE,0,66,6,6,12,7,7,14,7,0.27364,0.302028,54.50002,2,0.000598
Dayme y El High,Dayme y El High,,236161,52,4JreHVYyb6GqE2BU03Kx96,0,66,12,26,38,14,34,48,7,0.312253,0.360075,1026.471512,0,0.001199
Camila,Camila,,3617038,69,2gRP1Ezbtj3qrERnd0XasU,0,66,5,5,10,6,5,11,8,0.248819,0.268395,376.739121,6,0.000961
La Joaqui,La Joaqui,,112591,56,60XHOAhvEBiV6BGBOv8ClM,0,66,1,2,3,1,4,5,8,0.240268,0.259998,39.4945,10,0.000288
Canserbero,Canserbero,,4819393,70,1wGIhYkKWSq4yACtTkCkSX,0,66,2,2,4,2,3,5,8,0.209382,0.223376,397.459368,2,0.000543
McKlopedia,McKlopedia,,221320,56,1PNgAcUW6UgN59okEaTpvG,0,66,10,6,16,14,6,20,7,0.252881,0.276555,6079.966218,2,0.002396
Rapsusklei,Rapsusklei,,310111,51,451DVjaBuGYfvDfvG9MxaG,0,66,9,9,18,12,12,24,8,0.231604,0.254662,6203.469827,13,0.002224
Jowell,Jowell,,134149,51,6TASDj2ogOKQptnxgEvrcP,0,66,12,7,19,24,8,32,7,0.256911,0.285756,361.210066,3,0.00132
Ñejo & Dalmata,Ñejo & Dalmata,,1183920,62,1ykothWH0xl8drRyJWuw7I,0,66,4,4,8,13,5,18,7,0.275838,0.306655,0.551162,0,0.000383
J-King y Maximan,J-King y Maximan,,151553,52,6UBb8ZUUyarsyod6snflAR,0,66,15,23,38,18,32,50,7,0.296881,0.342682,846.498844,3,0.00115
Carlitos Rossy,Carlitos Rossy,,256035,50,0FDJB5xf8i09jDjIg1qNED,0,66,6,22,28,39,47,86,7,0.300838,0.347122,1470.53622,0,0.000598
Nova y Jory,Nova y Jory,,785772,55,6ZK8loFAzWKSFe3b7Lrq4V,0,66,2,12,14,4,15,19,7,0.28407,0.319867,4.06569,0,0.000267
Olga Tañón,Olga Tañón,,724452,60,4pv1Jo4PbYI8LMADJoTWjE,0,66,7,1,8,8,2,10,7,0.267706,0.289268,132.518866,3,0.000649
Tito Nieves,Tito Nieves,,1111833,60,4vOycwLXdkMMzpZW04VW5m,0,66,6,3,9,11,5,16,8,0.253693,0.2731,1825.566825,6,0.001084
Lapiz Conciente,Lapiz Conciente,,251958,50,0UTsdD7VIsEB9i7a6DDx5t,0,66,9,10,19,10,11,21,7,0.292918,0.324867,1519.402074,13,0.00127
John C,John C,,210699,57,66lf5bQo2BIEue1pxfgxQS,0,66,7,2,9,12,3,15,8,0.211796,0.22761,127.497729,10,0.000764
Bunbury,Bunbury,,2077620,67,4uqzzJg3ww5eH7IgGV7DMT,0,66,13,6,19,22,6,28,8,0.23983,0.258139,5034.886037,6,0.002086
Caloncho,Caloncho,,644504,63,2z3KntXLyEF5Lvz1kpdBoA,0,66,4,4,8,6,5,11,8,0.241516,0.258552,1279.877942,6,0.000978
Esteman,Esteman,,261697,61,3ZtIhDSOuRkpDyqjx53X1R,0,66,8,9,17,9,13,22,7,0.271478,0.296148,4615.259507,6,0.001316
Chino & Nacho,Chino & Nacho,,2361856,64,5NS0854TqZQVoRmJKSWtFZ,0,66,4,11,15,7,26,33,7,0.297104,0.333496,508.474913,3,0.000458
Daniel Santacruz,Daniel Santacruz,,122741,53,4tLUnrSgMM7tT0zVs3wX61,0,66,3,4,7,5,5,10,7,0.266712,0.288846,1905.292531,11,0.000642
Pitizion,Pitizion,,101435,53,0GWdY55YF6xzN5L1A0X8nq,0,66,7,7,14,9,9,18,6,0.290655,0.318017,3475.539012,2,0.000912
Yannc,Yannc,,47436,52,3rqKgkODmiyDdimpz5D3y1,0,66,5,12,17,6,17,23,7,0.280142,0.316175,96.242535,0,0.000743
Flex,Flex,,235060,61,13VwGEitoK8J0qjNjbgeTN,0,66,4,6,10,6,8,14,7,0.283764,0.3105,818.866319,3,0.00049
Carlos Baute,Carlos Baute,,1686892,63,3smfreCkyJt7bShaTYpG77,0,66,8,11,19,11,19,30,7,0.306915,0.340371,1066.698168,6,0.000597
Midel,Midel,,325856,53,4EcIU574ksr6mC1GMEOe0p,0,66,7,7,14,10,13,23,7,0.256911,0.283406,165.165805,10,0.000933
Seven Kayne,Seven Kayne,,1100801,63,4C29ETLBPmYKYwtJUepbJz,0,66,7,13,20,8,18,26,7,0.27027,0.303264,398.701666,10,0.000901
Rusherking,Rusherking,,924115,71,3Apb2lGmGJaBmr0TTBJvIZ,0,66,15,14,29,28,24,52,7,0.287377,0.320244,6592.281663,10,0.002538
Zoé,Zoé,,4235523,71,6IdtcAwaNVAggwd6sCKgTI,0,68,0,1,1,0,1,1,9,0.193635,0.2028,0,6,0.0002
Santiago Cruz,Santiago Cruz,,878517,57,5ClJtuiNlr83ua45Dvpcf7,0,66,3,12,15,3,16,19,7,0.288743,0.316851,1667.093318,6,0.000546
Soledad,Soledad,,418712,58,0K59Fm1y7s3j498ueS4qzY,0,66,13,18,31,15,18,33,7,0.298903,0.332071,11418.480718,6,0.002203
Erik Rubin,Erik Rubin,,268738,53,43hb5av90CTCWFldaaTp7n,0,23,3,0,3,7,0,7,0,0,0,0,6,0.00048
Kumbia Kings,Kumbia Kings,,280546,53,3jO5UGHrEzfd5YIamfs7Ir,0,66,1,1,2,1,1,2,8,0.238887,0.256468,1.235802,6,0.000232
Joaquín Sabina,Joaquín Sabina,,2531335,66,4aeIWo5CMF1uRmqgJdwkZW,0,66,13,1,14,23,1,24,9,0.192308,0.203763,228.743536,6,0.001406
Nach,Nach,,772012,57,66ArjpKRgw8vYBf9yhktto,0,66,5,6,11,5,6,11,7,0.275549,0.296037,4492.472512,13,0.000559
Moderatto,Moderatto,,756518,63,5XsWrYhwadPBjW20qYbdZg,0,66,4,9,13,9,15,24,7,0.280939,0.307336,3841.602538,6,0.00044
Lasso,Lasso,,344779,72,3SCOuAxngTC1yGjKMcIPEd,0,66,9,4,13,15,9,24,6,0.275934,0.2977,900.587247,2,0.00092
Kaydy Cain,Kaydy Cain,,362875,62,4nXXIxTneJksvGXrlmX8oA,0,66,14,9,23,32,23,55,7,0.258254,0.288906,1798.021158,10,0.001531
DELLAFUENTE,DELLAFUENTE,,575101,63,4bJh7sMPcVRiqe5jlnsWQV,0,66,5,7,12,12,10,22,7,0.275549,0.300973,1008.902565,10,0.00067
Bejo,Bejo,,222623,66,0adJG3bdFTHCkTY28NkY4u,0,66,13,6,19,21,17,38,8,0.223227,0.246472,4651.001977,10,0.002164
Camin,Camin,,88046,58,3qndygm4Vx7bEW8tNyDKSY,0,66,9,9,18,12,14,26,7,0.261676,0.292788,1203.137705,13,0.001104
Monica Naranjo,Monica Naranjo,,617040,59,0zGM73sadbAOBLev02P8LO,0,66,2,1,3,3,2,5,9,0.193485,0.202424,30.552933,6,0.000554
Celso Piña,Celso Piña,,265200,57,6PmfbeAL7jAauFPNyQ5UPi,0,9,5,0,5,7,0,7,0,0,0,0,6,0.000891
María León,María León,,56399,56,132xFnGXTZoDfZWuMDE4tc,0,66,8,6,14,8,10,18,7,0.268616,0.294681,470.987306,6,0.000676
Intocable,Intocable,,2793788,72,108moq3rq6bm1M4Ypz0J02,0,66,5,2,7,5,2,7,7,0.233314,0.246832,306.90721,6,0.001024
Lucas Arnau,Lucas Arnau,,240920,52,5vLOlJcOKe9DfBC5LeLpSs,0,66,2,7,9,2,7,9,7,0.288111,0.313008,308.55652,6,0.000334
José Luis Perales,José Luis Perales,,1826639,63,5RwfJb8wxN1fuodcPORVxP,0,66,2,3,5,6,16,22,8,0.2252,0.2403,348.743332,6,0.000337
José Luis Rodríguez,José Luis Rodríguez,,829504,59,15YnmlNukYCFvwaFnoDwwV,0,66,1,7,8,3,10,13,7,0.273451,0.299753,844.334794,6,0.000267
Mercedes Sosa,Mercedes Sosa,,765730,57,2HvyR5FsU37QMqVzIbGwl7,0,66,7,17,24,13,20,33,7,0.289802,0.321386,6832.267887,6,0.001448
Camilo Sesto,Camilo Sesto,,3071949,64,2Cy7KBSkqu7otJfuMTWT7Y,0,66,1,5,6,2,5,7,8,0.261157,0.286097,121.970525,6,0.000267
Leo Dan,Leo Dan,,2104194,66,6qhOH2mrlqUDod9sWA5kR2,0,66,6,16,22,6,16,22,7,0.285096,0.318803,5976.910651,6,0.000814
Abel Pintos,Abel Pintos,,3172574,67,6HTUcOExehqydqa7C3usAa,0,66,18,10,28,28,12,40,7,0.265636,0.290892,6521.490705,6,0.002799
Yuridia,Yuridia,,2848729,70,5B8ApeENp4bE4EE3LI8jK2,0,66,7,5,12,11,5,16,8,0.27364,0.296789,459.923446,6,0.000673
WOS,WOS,,2853119,71,5YCc6xS5Gpj3EkaYGdjyNK,0,66,4,4,8,5,4,9,7,0.246952,0.266212,314.823976,10,0.000716
Leïti Sene,Leïti Sene,,31685,52,5FQJWdcKPAijmEi4uroZ4h,0,66,3,4,7,6,6,12,7,0.240414,0.262098,400.694862,10,0.00049
Manuel Medrano,Manuel Medrano,,2130309,65,0i5iO6icb7kxg48thi9gBM,0,66,4,3,7,6,3,9,8,0.239903,0.257722,97.09165,6,0.000658
Angel Y Khriz,Angel Y Khriz,,862702,63,7npqy7rgdX2D3yfVyWExKo,0,66,8,11,19,12,11,23,7,0.283866,0.32116,867.046445,3,0.000689
Casa De Leones,Casa De Leones,,532398,53,26YAHs5On4KQDNsU2cYFdL,0,65,1,0,1,1,0,1,0,0,0,0,3,0.000242
Super Yei,Super Yei,,356266,62,6HqgxkTt9KGyt27zYrwVan,0,66,1,20,21,1,58,59,7,0.298001,0.340645,9.566143,0,0.000242
Big Yamo,Big Yamo,,48426,59,1a2HwAlOE2wUPmNisvZxSw,0,64,1,0,1,1,0,1,0,0,0,0,3,0.000242
Ely Guerra,Ely Guerra,,364203,51,1ne2c2YEgt4MmJCJGCsfsZ,0,8,4,0,4,4,0,4,0,0,0,0,6,0.000859
Jorge Drexler,Jorge Drexler,,701468,64,4ssUf5gLb1GBLxi1BhPrVt,0,66,13,7,20,26,9,35,7,0.275838,0.298195,4885.924843,6,0.002011
Los Auténticos Decadentes,Los Auténticos Decadentes,,1718253,67,3HrbmsYpKjWH1lzhad7alj,0,66,8,18,26,10,23,33,7,0.270085,0.300844,7495.416513,6,0.000751
Panteon Rococo,Panteon Rococo,,2220594,65,11mqrDSFRRz8g0Wb3syJj5,0,66,4,6,10,5,7,12,8,0.248897,0.269242,1080.578003,6,0.000564
Kevin Johansen,Kevin Johansen,,330546,55,7qjoG7bwhAjSd7nJTcjgAk,0,66,1,5,6,3,10,13,8,0.253612,0.274363,78.025351,6,0.000323
Ximena Sariñana,Ximena Sariñana,,1262450,64,7plUpXSFcSJUZSiZAoXqr1,0,66,15,9,24,24,9,33,7,0.265546,0.291019,8219.614293,6,0.00273
León Larregui,León Larregui,,1716798,65,4ClsVDy2g7RKSSlvq8cF6d,0,66,3,1,4,3,1,4,8,0.229451,0.24131,129.335412,6,0.000689
Vicentico,Vicentico,,1392853,64,25THA9HUHoxpCT4LBp7UsZ,0,66,11,4,15,18,4,22,7,0.260125,0.282634,4091.764486,6,0.001292
Eddie Dee,Eddie Dee,,440572,56,7zLcnirfgw1VEHHshuGcDR,0,66,4,2,6,6,2,8,8,0.23463,0.25253,8.740748,3,0.000489
Oscar D'León,Oscar D'León,,1198259,57,1c84wItoiAe1pEbpJMqUmQ,0,66,5,2,7,5,3,8,9,0.215083,0.226171,302.516747,6,0.000754
Jesús Adrián Romero,Jesús Adrián Romero,,3381133,70,29SeiO68HQHBs7pDdWOvvX,0,66,6,6,12,11,9,20,9,0.232353,0.252784,4203.541111,8,0.001108
Marcos Vidal,Marcos Vidal,,343146,50,03CueHDpVcwXQZHeBlZUkd,0,66,4,2,6,6,2,8,8,0.220056,0.231043,1151.58234,8,0.000825
Marcela Gandara,Marcela Gandara,,1447690,63,2zF0KCQEt1O4Z9fWVUVi4T,0,66,9,5,14,13,6,19,9,0.207404,0.224273,1807.405301,8,0.001495
Alex Campos,Alex Campos,,1438392,61,6slyJwua5e5GuhuP82sTHR,0,66,15,14,29,21,22,43,8,0.260211,0.289931,11309.652074,8,0.002231
Lilly Goodman,Lilly Goodman,,1343461,61,6vetaGijEBK3wfhtCUWRBS,0,66,3,3,6,4,4,8,9,0.213341,0.228779,1447.814798,8,0.001057
Abel Zavala,Abel Zavala,,471959,52,0UH4eoqwQgADwRoaKtEKc1,0,66,1,1,2,2,1,3,10,0.171851,0.180774,0,8,0.000357
Rvfv,Rvfv,,289231,73,2CCgb0KApjfQDuTppovpf8,0,66,9,14,23,10,20,30,7,0.282546,0.31862,2355.764832,10,0.001186
Harry Nach,Harry Nach,,205675,64,0NnUMWDCDi1snuMja6IdxH,0,66,8,12,20,10,19,29,7,0.263158,0.297137,1212.970483,10,0.001339
ZARAMAY,ZARAMAY,,171197,56,3wsYquQ9CiMlYG54BUR2ff,0,66,5,9,14,5,9,14,7,0.274306,0.304901,2102.537138,10,0.000805
Cristian Castro,Cristian Castro,,2549100,69,2AZOALDIBORfbzKTuliwdJ,0,66,10,7,17,12,8,20,7,0.288743,0.314792,3014.553069,6,0.001387
Enrique Guzman,Enrique Guzman,,470880,53,4FeDV8T2wgjzYKBamSp7MG,0,66,2,9,11,2,10,12,8,0.272696,0.298487,251.185859,6,0.000278
Sergio Dalma,Sergio Dalma,,698408,57,7x6XYw3yCC67Pizi4o0wvZ,0,66,3,2,5,4,2,6,8,0.232353,0.246145,8.301773,6,0.000431
Dyango,Dyango,,773156,55,0PbO1lSBsJPgyqdEypJJVb,0,66,3,1,4,12,1,13,9,0.189721,0.197447,118.581857,6,0.000448
Miranda!,Miranda!,,841323,66,2eEmsgWmUFMbtU7agJpnjY,0,66,7,7,14,8,8,16,8,0.2528,0.27436,4192.762093,6,0.000934
Kinky,Kinky,,466403,55,4WOIfFwyvx22jM0eg2fpKv,0,66,7,2,9,7,5,12,7,0.243227,0.257064,1763.228415,6,0.000966
Tercer Cielo,Tercer Cielo,,1410412,60,2bimgkRmsxRhhuWsOnd5rz,0,66,3,3,6,5,5,10,9,0.204134,0.220243,591.905506,8,0.000373
Marcela Morelo,Marcela Morelo,,62636,51,63xFjf6Ww22O5gHrBP79G9,0,66,2,6,8,3,8,11,8,0.261936,0.28643,425.550971,6,0.000542
Ciro y los Persas,Ciro y los Persas,,846706,59,2Eo4Yaukt9d6dnZrY5hQKi,0,18,3,0,3,3,0,3,0,0,0,0,6,0.000577
Leiva,Leiva,,612481,63,5Hsv8dUHHOdnn72q4XIVz7,0,66,17,12,29,20,15,35,8,0.238024,0.262878,6649.774955,6,0.003377
Karina,Karina,,219276,57,1QZuAtDYNrk2QMogJulsyq,0,66,1,2,3,1,2,3,8,0.238959,0.254668,82.869102,6,0.000438
Nahuel Pennisi,Nahuel Pennisi,,78732,58,4IjHltwoSKbUeZLPeULyDe,0,66,4,1,5,4,2,6,8,0.209939,0.221272,53.886318,6,0.000635
Hombres G,Hombres G,,3160195,70,60uh2KYYSCqAgJNxcU4DA0,0,66,4,7,11,5,9,14,8,0.263597,0.289173,3017.314455,6,0.000712
Los Enanitos Verdes,Los Enanitos Verdes,,3077213,70,4TK1gDgb7QKoPFlzRrBRgR,0,66,4,2,6,4,4,8,9,0.211286,0.22521,1601.431879,6,0.000663
Ana Torroja,Ana Torroja,,594077,59,5YekZn3GGnPIURNA6RG124,0,66,10,8,18,16,11,27,8,0.27729,0.305068,2206.297296,6,0.001085
Bebe,Bebe,,427465,57,2byU53ebtTxcAnIRE814Ts,0,66,6,4,10,6,5,11,8,0.261676,0.280876,938.995538,6,0.000604
Vicente Garcia,Vicente Garcia,,383274,62,2Otnykd696YidQYfEGVmNq,0,66,5,3,8,7,4,11,8,0.231197,0.246126,401.273921,6,0.000852
Toño Rosario,Toño Rosario,,236097,50,4DjY0CaKAejJgghVHTaOUy,0,2,5,0,5,6,0,6,0,0,0,0,3,0.000958
Delaossa,Delaossa,,166547,60,5Uox3n7m4W2CoM9MmHPJwQ,0,66,9,11,20,28,21,49,7,0.259357,0.287095,6332.061574,10,0.001695
TAICHU,TAICHU,,66185,52,3ou3XMRNmyDSy6gnC1bSgN,0,66,3,3,6,4,4,8,7,0.251272,0.270766,1063.456067,10,0.001159
No Te Va Gustar,No Te Va Gustar,,1836500,66,4ZDoy7AWNgQVmX7T0u0B1j,0,66,3,4,7,4,6,10,7,0.259271,0.278749,722.235775,6,0.000374
León Gieco,León Gieco,,235620,52,5yoimVE1rbc3kAx4uwr7eq,0,66,9,5,14,18,7,25,8,0.225135,0.240879,2614.363758,6,0.001382
Marta Sánchez,Marta Sánchez,,321457,62,368rTiMKMrz3b03az6B14w,0,66,3,7,10,5,9,14,7,0.284377,0.309626,294.977241,6,0.000338
Sinfonico,Sinfonico,,112228,55,17vZy9fIIt6woqdWfc7UCy,0,66,7,7,14,9,13,22,8,0.250953,0.27942,76.503129,0,0.00083
Neutro Shorty,Neutro Shorty,,662216,62,5wUO3A6DT4tO5UDz21kE2Y,0,66,11,19,30,31,39,70,6,0.303846,0.346371,6324.094865,2,0.001566
La Oreja de Van Gogh,La Oreja de Van Gogh,,2928349,70,4U7lXyKdSf1JbM1aXvsodC,0,66,2,8,10,6,8,14,8,0.262983,0.288244,723.586388,6,0.000421
Alex Ubago,Alex Ubago,,1884595,64,2tY2GFdhH0Wa2VBvsxew5X,0,66,8,9,17,11,15,26,7,0.28154,0.306323,2980.20242,6,0.001331
David Otero,David Otero,,157728,56,4cA5JN7tiNZ8afYeuSQj5h,0,12,2,0,2,3,0,3,0,0,0,0,2,0.000343
Selena,Selena,,2867275,69,6IE6z7DcZIT4Ml3Fh5Ivch,0,69,1,4,5,4,8,12,7,0.280951,0.303971,507.84374,6,0.000273
Alvaro Torres,Alvaro Torres,,247400,54,7p5DVejD1eXP8GO6clYQlE,0,69,1,3,4,2,6,8,8,0.231376,0.244524,12.106556,6,0.000258
LOUTA,LOUTA,,154876,58,5l4GdLELvdnXZVT5g947i3,0,66,4,4,8,4,4,8,7,0.247261,0.268309,1075.030955,10,0.000712
Carolina Ross,Carolina Ross,,372514,57,5wx70QuZtxRUIIYek3RSaV,0,66,2,2,4,2,3,5,8,0.253774,0.273359,225.863274,6,0.000779
Silvio Rodríguez,Silvio Rodríguez,,1146130,62,4rUyBlggM5tZUH5QZn9ZuO,0,47,2,0,2,4,0,4,0,0,0,0,6,0.000337
John Leguizamo,John Leguizamo,,3396,51,26nStRV6Waedt17W4Uhx6l,0,52,1,0,1,1,0,1,0,0,0,0,6,0.000311
Totó La Momposina,Totó La Momposina,,105527,51,26BL0aeVS96sje8JfCNfUk,0,10,3,0,3,4,0,4,0,0,0,0,6,0.000464
Café Tacvba,Café Tacvba,,2522435,67,09xj0S68Y1OU1vHMCZAIvz,0,6,2,1,3,2,1,3,1,1,1,16.5564,6,0.003633
The Noise,The Noise,,28212,53,0xbdsXms9xTAtNmROodyy8,0,66,1,9,10,17,39,56,7,0.277875,0.312622,2.473131,3,0.000234
Efecto Pasillo,Efecto Pasillo,,384340,55,6CSa1r92LtHHdLG6kRabU3,0,66,2,3,5,2,5,7,7,0.252154,0.272559,642.220732,2,0.000347
Angel Lopez,Angel Lopez,,5512,56,0w57qOEVTcqs0bLyFJ7Q52,0,58,2,0,2,9,0,9,0,0,0,0,2,0.000281
Eddy Lover,Eddy Lover,,390002,60,7gR53ad9JjCweCv4f9MWEX,0,66,3,5,8,5,11,16,7,0.256994,0.277929,2229.302552,2,0.000415
Los Fabulosos Cadillacs,Los Fabulosos Cadillacs,,2557262,66,2FS22haX3FYbyOsUAkuYqZ,0,7,1,0,1,1,0,1,0,0,0,0,6,0.000435
Benny,Benny,,254921,58,3YHFRVdfHlJ98iAc50PIYk,0,66,10,4,14,12,6,18,8,0.239177,0.258751,2854.63719,6,0.001429
Ana Bárbara,Ana Bárbara,,1019447,64,43qxAkuKFB6fMNSeS5dO7Z,0,66,4,1,5,4,1,5,8,0.224113,0.23569,60.560052,6,0.000644
Gustavo Santaolalla,Gustavo Santaolalla,,244263,61,4W3fa7tiXGVXl3KilbACqt,0,6,4,1,5,4,1,5,1,1,1,160.001448,6,0.003908
Monsieur Periné,Monsieur Periné,,517532,60,36KsCCwgI0Dep97yVJWmkK,0,66,6,5,11,7,7,14,7,0.268251,0.288023,759.970453,6,0.000757
Dulce María,Dulce María,,668945,69,6kaefrHSdAvxhhCVDFTCEL,0,66,5,5,10,22,6,28,7,0.277973,0.303707,827.452791,7,0.000535
Luis Enrique,Luis Enrique,,839761,59,2mUI4K6csTQd3jieswcmiI,0,66,8,3,11,11,5,16,7,0.25817,0.27947,780.493928,6,0.000712
Diego Torres,Diego Torres,,1729256,64,0LALueHEQunQ2d61fXGeZh,0,66,6,11,17,7,17,24,7,0.292918,0.320151,2724.999025,6,0.000596
La Quinta Estacion,La Quinta Estacion,,2343553,64,7FZj349hdLfD6qzXkJLuAh,0,70,0,2,2,0,5,5,8,0.238901,0.253478,0,6,0.0002
Grupo Niche,Grupo Niche,,2341250,67,1zng9JZpblpk48IPceRWs8,0,71,1,0,1,1,0,1,0,0,0,0,6,0.000234
Bulin 47,Bulin 47,,274572,53,4J0m1OquRGY8HYHxMocXfy,0,66,5,13,18,21,39,60,7,0.265725,0.300196,70.249163,13,0.000859
Yung Sarria,Yung Sarria,,79667,57,3vxYNXtM9uOMdRAXTXgtmf,0,66,6,2,8,18,12,30,8,0.203242,0.215118,1163.755287,4,0.000901
Elpatron970,Elpatron970,,109778,60,2rPOaAdN74S2D0Kw3ImL5O,0,66,4,3,7,15,6,21,8,0.204822,0.218071,1595.075892,4,0.001821
Beny Jr,Beny Jr,,477856,69,22dFwJoRBV51ue5TGnC7Dt,0,66,3,4,7,4,7,11,7,0.258677,0.283418,19.579476,10,0.000539
Inspector,Inspector,,1106354,64,4OiCK9NnTWhakDIG57uBUA,0,66,3,5,8,3,8,11,8,0.214092,0.229114,195.119744,6,0.000543
Alexander Acha,Alexander Acha,,519506,56,3JkgQ8Jjwt2mkeOsg5yhqh,0,66,2,3,5,2,8,10,8,0.23463,0.249328,836.075428,6,0.000393
Natalia Lacunza,Natalia Lacunza,,191015,57,3Zs59sqZJ6fWQqWbRC8bOP,0,19,2,0,2,2,0,2,0,0,0,0,6,0.000496
Tito Rojas,Tito Rojas,,1007021,55,2kgCV0fFS0wt3q6M5B39nH,0,22,6,1,7,7,1,8,1,1,1,72.631117,3,0.000655
Eddie Santiago,Eddie Santiago,,1321307,64,5Wg6XnPTp0xXxFCjywwR9I,0,20,1,0,1,1,0,1,0,0,0,0,6,0.000297
Guaco,Guaco,,232606,50,5v3TYN6Mmi5vxV2uSOfXot,0,66,1,4,5,2,6,8,8,0.261936,0.282479,33.406744,6,0.000297
Tony Vega,Tony Vega,,743613,56,3Yg61bt7pZYX1bbMXEj8oY,0,66,3,1,4,3,1,4,9,0.20246,0.212223,63.315279,6,0.000401
Diego Verdaguer,Diego Verdaguer,,1031381,63,2UFqwY8A3PLcx8pAkg9g5P,0,66,2,1,3,10,7,17,9,0.192589,0.201487,0,5,0.000616
DLD,DLD,,709525,62,7CwiLiC1S8B69RMPxbDb6S,0,66,2,2,4,2,2,4,8,0.223416,0.239274,187.980007,6,0.000352
Amanda Miguel,Amanda Miguel,,1317478,60,3v8mFhjLFa50QK8zDvAMYN,0,66,3,2,5,9,10,19,8,0.238455,0.255542,842.238528,5,0.000878
Alicia Villarreal,Alicia Villarreal,,669211,60,6Hf2g14O2TP25JUNZuvIgn,0,66,2,5,7,2,18,20,7,0.26816,0.290395,59.796025,6,0.000284
Los Caligaris,Los Caligaris,,881010,63,13wFTN72PGSUxzEHJP5Ljs,0,66,4,5,9,7,5,12,8,0.232353,0.24947,874.135339,6,0.000549
Sticky M.A.,Sticky M.A.,,105990,55,5o7fmoqHl79fzoCzeApdxm,0,66,6,8,14,9,17,26,7,0.26519,0.293092,1524.87178,10,0.000808
Alizzz,Alizzz,,51794,56,23herDudxPBB3S81GB5uG3,0,66,5,3,8,8,4,12,7,0.268525,0.290374,963.786265,10,0.000687
Israel B,Israel B,,46756,58,16M8fuShcwX8uBDdmFZH9B,0,66,15,13,28,44,44,88,7,0.26816,0.29805,3056.03745,10,0.002077
LOWLIGHT,LOWLIGHT,,10636,53,7LHU5Uga349zOVMpDPf4ij,0,66,6,7,13,30,23,53,8,0.25353,0.277841,768.974748,10,0.000993
Vetusta Morla,Vetusta Morla,,658055,59,6J6yx1t3nwIDyPXk5xa7O8,0,66,2,4,6,3,4,7,8,0.225071,0.241426,1635.114908,6,0.000812
Mikel Erentxun,Mikel Erentxun,,122597,56,7thnnayFyJnVOAJrpe5wMC,0,66,2,4,6,2,7,9,8,0.239321,0.257105,56.57474,6,0.000588
Jesse Baez,Jesse Baez,,116286,57,4rriNpL1lxpoysDDctWgl3,0,66,4,6,10,6,10,16,7,0.282546,0.30708,2103.186067,10,0.000916
C-Kan,C-Kan,,2035686,68,1QhaqxeqF9sipS2gwbEKpu,0,66,6,6,12,13,8,21,9,0.191934,0.205314,3917.930215,2,0.001083
Fyahbwoy,Fyahbwoy,,105935,51,6uFTGm4t8Z6tXyCm22sLQM,0,66,8,5,13,13,6,19,9,0.210051,0.224758,2250.069347,13,0.001134
MC Magic,MC Magic,,284522,52,3cuVSUrq0yoSSP7gpvI6q1,0,66,3,3,6,5,5,10,9,0.208995,0.223495,775.022581,2,0.000503
Lil Rob,Lil Rob,,386222,53,7B7TGqQe7QTVm2U6q8jzk1,0,59,3,0,3,3,0,3,0,0,0,0,2,0.000584
Kinto Sol,Kinto Sol,,728167,50,0nOyxRsVicKeiBbB6zdIMu,0,66,2,2,4,3,2,5,10,0.164071,0.171846,188.956072,4,0.000469
Santa RM,Santa RM,,532285,58,30BSBWLKnYJION1lCPugXc,0,66,2,2,4,3,3,6,9,0.19603,0.207764,1054.839493,10,0.000552
Big Metra,Big Metra,,20857,50,5J5DLfdC5YmPjVk8ljdOqU,0,0,1,0,1,1,0,1,0,0,0,0,2,0.000353
Motel,Motel,,193909,56,19IsMFpELM7g2UDuwDlZvU,0,66,1,3,4,1,6,7,7,0.265814,0.285036,4.468549,6,0.000241
Mœnia,Mœnia,,728528,62,3QmmtMrEf7aQrsd1VtejAV,0,66,1,2,3,1,2,3,8,0.239249,0.256148,0,6,0.000241
Yahir,Yahir,,983120,57,1bqHIHJm8coUJqqoguolZJ,0,39,2,0,2,2,0,2,0,0,0,0,6,0.000342
Plastilina Mosh,Plastilina Mosh,,601462,52,4PtVXWSOmF4Tox1jj6ctSq,0,38,2,0,2,2,0,2,0,0,0,0,6,0.000341
Café Quijano,Café Quijano,,345095,56,2ECP3nWC88LaFz4oQzTo3Z,0,66,1,6,7,1,9,10,8,0.264923,0.288606,22.021312,6,0.000241
Fito y Fitipaldis,Fito y Fitipaldis,,1592120,65,1tZ99AnqyjgrmPwLfGU5eo,0,66,5,1,6,5,1,6,8,0.234561,0.247759,1682.179788,6,0.000787
Rodrigo,Rodrigo,,1320201,58,235Vf4hkmwvxjVEMuCbRxm,0,66,2,3,5,3,3,6,7,0.262546,0.281281,928.06938,6,0.000369
Alejandro Lerner,Alejandro Lerner,,295826,58,6ESkuwldylZr39AIAPC63J,0,66,6,1,7,6,1,7,8,0.22329,0.237238,427.422107,6,0.000721
Molotov,Molotov,,1971602,65,27Owkm4TGlMqb0BqaEt3PW,0,72,0,1,1,0,1,1,8,0.196717,0.205721,0,6,0.0002
Ana Tijoux,Ana Tijoux,,383578,56,40JMTpVRUw90SrN4pFA6Mz,0,66,5,4,9,9,4,13,7,0.244582,0.262155,2059.46621,6,0.001155
Charlie Zaa,Charlie Zaa,,149289,55,1KfBKoozFugeT1PBkz33xl,0,66,1,6,7,1,6,7,8,0.27768,0.302895,273.129336,6,0.000344
Charly García,Charly García,,1282315,62,3jO7X5KupvwmWTHGtHgcgo,0,66,9,1,10,12,3,15,9,0.196225,0.205535,284.563755,6,0.001378
Alex Zurdo,Alex Zurdo,,1277701,63,0WI8OfWCRvK4nGHmKfFQmd,0,66,9,13,22,32,35,67,8,0.251432,0.281322,7503.157825,8,0.001457
Funky,Funky,,609631,61,4B4YYJ0BAYBK86yxqQV7mu,0,66,7,12,19,31,36,67,8,0.254674,0.283995,5178.697092,8,0.000981
Un Corazón,Un Corazón,,381529,58,4UGA0TDpRVVt2SCz8FZOMm,0,66,9,4,13,19,10,29,9,0.201943,0.218905,1194.050754,8,0.001781
Evan Craft,Evan Craft,,527729,59,4vEpUOtKWtpotWkuv0Vlx4,0,66,11,14,25,16,31,47,8,0.218837,0.244001,3777.686245,8,0.002092
Annette Moreno,Annette Moreno,,265061,51,3ECxfxbxwRMTXdy1I5HWJq,0,66,3,2,5,5,2,7,9,0.203085,0.217817,539.940605,8,0.000458
Jay Kalyl,Jay Kalyl,,168272,53,0sHeKC0Zcxpz4wOHHE5oJ7,0,66,6,1,7,9,3,12,8,0.202772,0.21564,577.668699,8,0.000904
Christine D'Clario,Christine D'Clario,,1067910,61,6JaSyvyg28SHC0Of8YE6M9,0,66,9,2,11,17,2,19,10,0.154811,0.164312,139.404967,8,0.00112
Julio Melgar,Julio Melgar,,838598,59,5O46r5EwzdUL8RR1aM6yU2,0,66,4,4,8,4,4,8,10,0.164412,0.177343,706.149628,8,0.001014
Miel San Marcos,Miel San Marcos,,1268245,62,7zpvy5B9gb5KprNUzNCOEE,0,66,8,10,18,11,15,26,9,0.195255,0.215473,3338.670011,8,0.001595
Barak,Barak,,686365,59,2IzxJqK9NbSIdw7rQVW03P,0,66,2,7,9,4,17,21,8,0.217631,0.237587,38.891042,8,0.000418
Marcos Brunet,Marcos Brunet,,515320,54,7cLoxFihGCVL3s1K3xHK4I,0,66,9,1,10,45,1,46,9,0.169201,0.177606,1388.397097,8,0.001781
Danny Berrios,Danny Berrios,,388603,51,3e6e7N2fMD8rtk2PBVyMkm,0,66,1,1,2,1,1,2,9,0.20659,0.219968,0,8,0.000283
La Beriso,La Beriso,,1744582,58,0Dy32zfSrQ332Bz8wsthKJ,0,66,1,7,8,1,9,10,7,0.248428,0.268816,140.19065,6,0.000304
Coti,Coti,,252478,63,1OUDQLymoysITxprkd0Qvj,0,66,7,12,19,11,19,30,7,0.280341,0.307254,5033.21767,6,0.000858
Ventino,Ventino,,1305070,52,1G89WXRVVAEjU4VIwgg6XD,0,66,3,4,7,3,4,7,7,0.269993,0.292936,58.379836,2,0.000481
Macaco,Macaco,,403802,60,7mUBMaZW1MXGswaneb0JTT,0,66,7,13,20,8,20,28,7,0.286025,0.313074,6099.828313,6,0.00066
Jorge Villamizar,Jorge Villamizar,,94200,53,3zPWcnruZBNnrd22uS8UBy,0,66,1,6,7,1,7,8,7,0.268616,0.290024,60.44606,6,0.000246
Angela Torres,Angela Torres,,128670,54,6LZA6PhNCwUfHzqfpN1nYL,0,66,4,3,7,4,3,7,8,0.240707,0.25973,1449.879281,2,0.000503
Sen Senra,Sen Senra,,112693,56,5lWasZeo8uWQk6GD8czJLq,0,66,2,3,5,2,4,6,7,0.268799,0.290838,162.597804,0,0.000592
El Kuelgue,El Kuelgue,,215837,54,6jRUKVZllu1wtgXHbqvUmT,0,66,2,1,3,3,2,5,8,0.217272,0.230561,62.460854,6,0.000549
Attaque 77,Attaque 77,,470340,56,5rI6C5mJm6GYXbGHhpHTu9,0,54,1,0,1,2,0,2,0,0,0,0,6,0.000235
Bandalos Chinos,Bandalos Chinos,,216296,59,0wn2qDKzeFlhjRUtJAwJjp,0,66,3,2,5,5,2,7,8,0.207676,0.219286,348.438164,6,0.000563
Los Pericos,Los Pericos,,1129635,62,7FnZWGw9lwOr7WzieTKEPR,0,66,3,6,9,3,8,11,7,0.267887,0.288737,1313.491997,6,0.000326
Chaqueño Palavecino,Chaqueño Palavecino,,432013,56,1GlOpg3dPUft550esb82K3,0,44,5,0,5,6,0,6,0,0,0,0,6,0.000621
Gepe,Gepe,,320344,55,1fHGzTSloWCtrlKfbLNVhM,0,66,3,2,5,4,3,7,8,0.237594,0.252842,128.944731,6,0.000622
Babasónicos,Babasónicos,,1092186,67,2F9pvj94b52wGKs0OqiNi2,0,66,1,2,3,3,2,5,8,0.196078,0.204354,45.022201,6,0.000235
Bersuit Vergarabat,Bersuit Vergarabat,,690897,60,6MxyNXnnmwQwdW2PD0gXYO,0,53,1,0,1,1,0,1,0,0,0,0,6,0.000235
Turf,Turf,,240162,54,0Zncosr79q01riJYbSBNA1,0,66,2,3,5,2,5,7,8,0.223669,0.237842,230.463241,6,0.000385
El Gran Silencio,El Gran Silencio,,898664,58,6pWTPhk1AtVfNmkaeXXVpD,0,66,4,2,6,6,2,8,8,0.223416,0.23929,521.04525,6,0.0004
Danny Romero,Danny Romero,,388290,55,30HlKUFTsqlFQsPfyv2yuM,0,66,6,11,17,9,13,22,7,0.304784,0.339928,592.955871,6,0.000686
Grupo Extra,Grupo Extra,,150421,57,4L5SLCIDWPPNGzrLraYCOS,0,66,2,2,4,4,4,8,8,0.241295,0.26016,58.665309,11,0.000379
Baby Bash,Baby Bash,,791639,61,12PSlydMSjEHzSCj9X5qv7,0,66,5,9,14,11,19,30,8,0.259698,0.287292,10026.161074,2,0.000937
Lennis Rodriguez,Lennis Rodriguez,,56554,54,4Rzu63KnqMsThOdfkrJk1Z,0,66,8,6,14,11,8,19,7,0.279745,0.304876,777.771702,10,0.000971
Lyan,Lyan,,45036,55,2GzKA5uPf3Nef6JjkUNk4H,0,66,6,10,16,9,14,23,7,0.275165,0.310133,716.462159,0,0.000629
Playa Limbo,Playa Limbo,,1601728,58,6XmHtVhgpE33VHFEp2V1P8,0,66,2,1,3,2,1,3,8,0.219505,0.231692,23.155389,6,0.000388
Pimpinela,Pimpinela,,1605046,60,7E7CVSqFdLyh0K4AE9uTMo,0,66,2,3,5,2,11,13,8,0.234074,0.248867,948.179713,6,0.000694
Los Nocheros,Los Nocheros,,495349,54,2ydE5oBt6cwsDxH1TpIFmO,0,66,5,2,7,5,2,7,8,0.213341,0.227134,158.276131,6,0.000676
Elefante,Elefante,,1553509,66,5oYHL2SijkMY52gKIhYJNb,0,66,2,2,4,2,2,4,8,0.234074,0.249867,700.193955,6,0.000323
Edgar Oceransky,Edgar Oceransky,,154881,54,6genEcweKnEZ92TZvdeLFl,0,66,2,8,10,2,13,15,8,0.242406,0.262717,241.511312,6,0.000363
Dharius,Dharius,,1554132,64,66RfYVdftqnuHRicyClgL0,0,73,0,1,1,0,6,6,10,0.161198,0.168489,0,2,0.0002
Miguel Ríos,Miguel Ríos,,211106,57,1dpnxi6xgoB2kaRYnnoatZ,0,66,3,7,10,3,7,10,8,0.231265,0.248466,2048.040938,6,0.000337
La Unión,La Unión,,452982,57,2Ax9wZpdlg4r2zkc3pcI8U,0,40,1,0,1,1,0,1,0,0,0,0,6,0.000285
Fer Palacio,Fer Palacio,,1494965,62,4frBEXn8nhWzOVwfCSpuYB,0,1,1,0,1,1,0,1,0,0,0,0,10,0.000266
JC el Diamante,JC el Diamante,,25833,50,1FxsUemFullSXJpySUsT0J,0,66,3,3,6,3,3,6,7,0.26211,0.281052,71.487889,10,0.000573
Eddy Herrera,Eddy Herrera,,422600,56,4yNdrUaF54csrLixVTnqzC,0,66,3,2,5,3,2,5,8,0.211456,0.223448,151.311894,11,0.000552
Marcos Witt,Marcos Witt,,1391045,61,4x7kxyIgzgtrHYDQ8SCzo2,0,66,10,3,13,15,5,20,9,0.184493,0.198047,1874.981758,8,0.001993
Elvis Crespo,Elvis Crespo,,828538,64,1c22GXH30ijlOfXhfLz9Df,0,66,5,17,22,5,21,26,7,0.296769,0.33302,3902.34871,3,0.000591
Seth Condrey,Seth Condrey,,67164,50,4DeiqSO9kyWDr1KuQTYMVg,0,66,3,3,6,6,3,9,9,0.207295,0.223976,69.444139,8,0.00074
Essential Worship,Essential Worship,,19658,50,5ovBCDCRU118CMxJ1KpAOw,0,66,6,6,12,6,10,16,8,0.233797,0.254739,4005.074732,8,0.001122
Su Presencia,Su Presencia,,213613,56,2gaFnEQydJdWNkT17NLZm3,0,66,3,2,5,6,3,9,9,0.206915,0.221234,311.619439,8,0.000787
Noriega,Noriega,,22476,59,3P4VNQLuN1qQQnL8rMaIkL,0,66,5,18,23,26,42,68,7,0.294776,0.33434,130.911975,3,0.000493
Christian Daniel,Christian Daniel,,75865,51,2fC8dVxeS2bsfIDvFj1M4V,0,66,2,6,8,2,7,9,7,0.289271,0.321175,54.299121,3,0.000327
RBD,RBD,,1405237,68,7cjh6y0V9SsyCrWSXTzwOs,0,66,1,4,5,1,60,61,8,0.240122,0.25849,783,7,0.000263
Anahí,Anahí,,665155,68,0TeVa4xdLB8vdzjsvKH6Ri,0,66,3,7,10,23,7,30,7,0.282445,0.310657,3386.937872,7,0.000521
Kudai,Kudai,,712828,57,0Wnd6L0qEnk8jiCIHrWXaC,0,26,1,0,1,1,0,1,0,0,0,0,7,0.000256
El Tri,El Tri,,1397551,61,3HgZDevp7GspkLUAa5cKne,0,29,2,0,2,2,0,2,0,0,0,0,4,0.00044
Johnny Prez,Johnny Prez,,148674,50,6gm3ZEpugRTHbtEn3A6Siw,0,66,3,11,14,3,13,16,7,0.278169,0.312019,1522.767073,3,0.00044
ChiChi Peralta,ChiChi Peralta,,536611,60,5GNSVtCq2hiXDx7jUA5Iou,0,66,1,2,3,1,2,3,8,0.23359,0.248027,318.780281,8,0.000499
Jarabe De Palo,Jarabe De Palo,,1336239,66,5B6H1Dq77AV1LZWrbNsuH5,0,74,0,7,7,0,14,14,7,0.267591,0.2906,0,6,0.0002
Celia Cruz,Celia Cruz,,473518,64,2weA6hhVqTIN2gSn9PUB9U,0,66,5,4,9,26,34,60,9,0.215847,0.228661,3951.473989,9,0.001224
Makano,Makano,,533742,53,5F73ZVq8ivLhsYF2pGg4Fc,0,16,3,0,3,4,0,4,0,0,0,0,6,0.000477
OV7,OV7,,1316384,59,5zaT4Qu9otu6z4oyWjRqM2,0,76,1,4,5,1,4,5,8,0.248589,0.267515,20.154886,6,0.000242
Kabah,Kabah,,787658,58,61hAcjvvUS6EXMpeeHwaDi,0,76,1,5,6,1,9,10,8,0.256468,0.276729,23.429956,6,0.000251
Sentidos Opuestos,Sentidos Opuestos,,869351,54,1xJAOe5igcfHGUbMHxsTBq,0,75,1,0,1,1,0,1,0,0,0,0,6,0.000251
La Ley,La Ley,,1290562,63,1ZVoRDO29AlDXiMkRLMZSK,0,30,1,1,2,1,1,2,1,1,1,7.878781,6,0.000241
Fabiana Cantilo,Fabiana Cantilo,,342704,54,5R6YR0pasdxlynyq0Abq7x,0,66,2,2,4,3,4,7,8,0.211739,0.222244,52.244029,6,0.000587
Luis Alberto Spinetta,Luis Alberto Spinetta,,689852,57,1MuQ2m2tg7naeRGAOxYZer,0,66,4,3,7,6,7,13,8,0.213341,0.224869,120.93922,6,0.000772
Pedro Aznar,Pedro Aznar,,292127,54,2FFrhWZS9vJsh2UvxYPRr6,0,66,2,4,6,4,7,11,8,0.244053,0.263015,934.013627,6,0.001443
La Renga,La Renga,,1279581,60,30fEdZPXgWfC4sNttcyB3C,0,80,1,1,2,2,1,3,8,0.196827,0.205603,0,6,0.000259
Pappo,Pappo,,346062,50,1db5TWniHR7iqwXer7AiQ2,0,80,1,6,7,1,11,12,7,0.244986,0.263014,793,6,0.00042
Kike Pavón,Kike Pavón,,295990,52,2TkDdk47FGnvxcjQGDdPd0,0,66,5,8,13,7,11,18,8,0.217272,0.23868,1150.124064,8,0.001118
Lead,Lead,,102529,50,5pyTY6jmdDNfKmmlo92Vfd,0,66,5,8,13,10,17,27,8,0.213456,0.235154,611.283057,8,0.001529
Samuel Hernández,Samuel Hernández,,448678,53,17XxPdvl2MD39MnT9zhNjU,0,66,1,3,4,3,4,7,9,0.204504,0.220475,0,8,0.000295
Nancy Amancio,Nancy Amancio,,482230,55,4225vUKDHwHhcYY9IRWwX0,0,66,1,1,2,2,1,3,10,0.16346,0.173678,0.866667,8,0.000295
Juan Carlos Alvarado,Juan Carlos Alvarado,,360813,56,1NWIpqck2zZ43JamLJgf6U,0,43,4,1,5,11,5,16,1,1,1,784,8,0.003018
Daniel Calveti,Daniel Calveti,,612240,53,4lZXpKLxWjMDFeNmiU4H1h,0,66,5,2,7,5,2,7,9,0.182406,0.194622,981.042159,8,0.001389
Marco Barrientos,Marco Barrientos,,1266945,61,4VYSLPSI9yb8qkUpKyVQSJ,0,66,4,6,10,6,9,15,9,0.187916,0.204785,34.513561,8,0.000846
Danilo Montero,Danilo Montero,,833699,56,2a48vLoCcVkOMcCSqXreOF,0,66,5,3,8,5,7,12,9,0.183806,0.197015,183.497253,8,0.001175
Girl Ultra,Girl Ultra,,113078,50,7i1CyQ1fogh4bkj3EPj3ls,0,66,3,3,6,5,4,9,8,0.230994,0.245429,807.925682,6,0.000957
Camilo Séptimo,Camilo Séptimo,,444871,60,6hQHiviB4JUWVmfykjYzcB,0,66,3,3,6,3,6,9,8,0.215611,0.228894,1304.922397,6,0.001205
Little Jesus,Little Jesus,,336942,57,5p1ARDx76hnOXoeigLIKit,0,66,6,5,11,7,9,16,8,0.232764,0.248654,1080.037464,6,0.001597
Elsa y Elmar,Elsa y Elmar,,148552,62,5nKGeITSNCVP76muyOlszy,0,66,8,5,13,11,5,16,8,0.222912,0.239798,2861.808955,6,0.001976
Toser One,Toser One,,298647,58,1oHPSeQJBwNmpq0J52Wjn1,0,66,3,2,5,3,2,5,8,0.215788,0.231719,157.550659,2,0.000811
Cano,Cano,,95845,61,60ZOYUFnCYEeKYsxgvPxOS,0,66,7,8,15,11,10,21,7,0.250873,0.278831,952.247307,13,0.00122
Musicologo Y Menes,Musicologo Y Menes,,162950,51,0xf0KaVp6AMWgesiBh6fee,0,66,1,28,29,2,74,76,7,0.310047,0.35994,406.325365,0,0.000402
ToteKing,ToteKing,,238068,51,224rbIjYbXaTI7lnP2ZMNJ,0,66,10,9,19,13,12,25,7,0.256078,0.281796,9034.863475,13,0.002328
Belanova,Belanova,,1000590,62,3oNy8cjBtJzLC07I70sklp,0,66,1,1,2,1,1,2,8,0.219201,0.231138,85.091532,6,0.000303
Soraya,Soraya,,380343,53,5enSNzCwMx61gCMv9jaV4Q,0,14,1,0,1,1,0,1,0,0,0,0,6,0.000303
Larry Hernández,Larry Hernández,,1224289,58,6djNDzSg08mnh2Ayoh6Ovn,0,60,1,0,1,1,0,1,0,0,0,0,2,0.000261
Los Cafres,Los Cafres,,1215179,60,2ST5XwWB4uXGKk2NXP8DUI,0,3,2,0,2,2,0,2,0,0,0,0,2,0.000373
Sergio Vargas,Sergio Vargas,,351370,52,4EzD52bDFGZTEeEucKHtDs,0,25,2,0,2,3,0,3,0,0,0,0,6,0.001332
Charles Ans,Charles Ans,,1187875,68,5lYeiQxUTcGKVgAuTqbTeL,0,66,7,5,12,9,6,15,9,0.200101,0.216519,3605.515267,10,0.001987
Simpson Ahuevo,Simpson Ahuevo,,239951,56,6viZnVSHavFUcW0blu6Mvw,0,66,1,2,3,2,2,4,9,0.195206,0.205353,157.411649,10,0.000538
Sabino,Sabino,,593136,65,0zgFL90nGTrH2iOMD8Vysy,0,66,4,1,5,6,1,7,10,0.166772,0.175478,284.597904,10,0.000786
M2H,M2H,,140533,50,7bWN0FHvLppK8ozEH6exdi,0,66,4,4,8,6,5,11,8,0.229185,0.246683,2119.185431,10,0.00105
Samantha Barrón,Samantha Barrón,,138483,58,0zfvfy9XlborSqXNRhi8Bk,0,66,3,2,5,4,2,6,8,0.211513,0.222975,715.983134,2,0.001218
Control Machete,Control Machete,,1145215,57,628gUkswCfCS1hIOOHmIpK,0,81,1,2,3,1,4,5,8,0.229209,0.244176,791,6,0.000369
Gondwana,Gondwana,,987452,60,4nSgEvZncnC5oNPVrtwnLd,0,66,2,1,3,3,1,4,9,0.189767,0.197434,91.072263,6,0.000333
Emanero,Emanero,,58094,59,2BTS8Np1YzPQuXjgdlqsBB,0,66,6,3,9,9,4,13,8,0.23738,0.255297,2610.505133,10,0.000992
Luck Ra,Luck Ra,,250798,62,4kcQWQDK0u9AftVSpdrAgk,0,66,6,7,13,11,11,22,8,0.246567,0.270249,1049.552378,10,0.000854
Lupita D'Alessio,Lupita D'Alessio,,1079535,55,3mGyF5kXDjEkLlFypJ93en,0,83,0,1,1,0,1,1,9,0.19321,0.203225,0,6,0.0002
Akwid,Akwid,,1078033,59,3mYFuz6iY7D9X78rOXg5CG,0,84,0,1,1,0,1,1,10,0.174614,0.182587,0,6,0.0002
Frankie Ruiz,Frankie Ruiz,,1049705,65,4dLvccxeQIM5u80Ri0u9OV,0,85,0,1,1,0,1,1,2,0.666667,0.75,0,3,0.0002
Panther,Panther,,63138,54,6bigFvZX5HdrC98srqxRLQ,0,50,1,0,1,1,0,1,0,0,0,0,10,0.000271
Fey,Fey,,1031817,58,3uC20p2EoNm5LYtzSVWdkL,0,86,0,1,1,0,1,1,8,0.219661,0.232031,0,6,0.0002
La Zowi,La Zowi,,155476,52,1jB62pOe5WpGiHOBDtKBBG,0,66,5,7,12,8,8,16,8,0.247649,0.276472,176.791649,10,0.000647
Blunted Vato,Blunted Vato,,270915,54,15RLdM61VHtknTIYIuNviR,0,66,4,4,8,7,9,16,7,0.243152,0.265862,287.832136,10,0.000774
Salastkbron,Salastkbron,,62708,59,3WMlRpW5JWuDI95TcEWt3r,0,48,2,0,2,2,0,2,0,0,0,0,10,0.000359
Fili Wey,Fili Wey,,76527,52,77pCqwW8HaKBjkTHe395eo,0,49,2,0,2,4,0,4,0,0,0,0,10,0.000406
Homer El Mero Mero,Homer El Mero Mero,,214137,62,0Xo4VFS3v07L0GwIVkZLfg,0,66,12,6,18,24,8,32,7,0.265814,0.293252,8960.903755,10,0.001197
TREN LOKOTE,TREN LOKOTE,,998976,58,6DjBv6gyR1HLsvwGUOD5V9,0,66,2,4,6,2,8,10,8,0.210723,0.226255,3616.175995,4,0.000544
Under Side 821,Under Side 821,,453886,55,2NtN73hhhgFt2NmbBOlFz1,0,62,1,0,1,2,0,2,0,0,0,0,4,0.000315
El Pinche Mara,El Pinche Mara,,658745,52,3L7OHIT4kfdcDSnnGM0TKN,0,66,2,1,3,7,1,8,10,0.152245,0.158817,784,4,0.00049
Joe Vasconcellos,Joe Vasconcellos,,264829,53,4sGC7K2rSpWrWudBgYPMce,0,66,3,2,5,3,3,6,8,0.233866,0.248009,1133.198083,2,0.000813
Bardero$,Bardero$,,297743,58,5Q2fyL2TcdUY9IqKTkGk5G,0,66,2,4,6,7,19,26,8,0.222723,0.243844,248.435072,10,0.000369
Recycled J,Recycled J,,184266,59,4bWHA8fMNjzfGPQqnh5D6y,0,66,13,9,22,38,18,56,7,0.250079,0.277119,2361.523393,10,0.001915
Selecta,Selecta,,14822,50,1m9WPOccw8sizsVYUhSVjZ,0,66,8,14,22,16,46,62,7,0.264745,0.29991,2000.862518,10,0.001248
Cruz Cafuné,Cruz Cafuné,,210026,68,0jeYkqwckGJoHQhhXwgzk3,0,66,14,8,22,20,11,31,7,0.250635,0.276377,1885.885859,10,0.002192
Frijo,Frijo,,603763,57,4D2d63igYEdzhzFnxrSow7,0,66,5,6,11,5,7,12,7,0.252477,0.279219,204.77355,10,0.000644
Yung Beef,Yung Beef,,317526,63,1rTUwYS38LkQTlT2fhikch,0,66,7,14,21,21,41,62,7,0.259527,0.290136,1579.398236,10,0.000995
Nicola Cruz,Nicola Cruz,,310891,52,0OltT51j3hIkgaDJqqPzDn,0,33,1,1,2,1,1,2,2,0.666667,0.75,11.167888,6,0.000265
Aterciopelados,Aterciopelados,,685797,56,3MqjsWDLhq8SyY6N3PE8yW,0,66,3,6,9,4,6,10,7,0.263773,0.282872,2567.036687,6,0.000492
Myriam Hernandez,Myriam Hernandez,,962137,59,6NHTDaYSUeMaroI5U0jytT,0,87,0,4,4,0,4,4,8,0.23626,0.253248,0,6,0.0002
Los Piojos,Los Piojos,,954826,59,0SnyKkoyBaB2fG8IJH4xmU,0,88,0,1,1,0,1,1,9,0.183953,0.192242,0,6,0.0002
DrefQuila,DrefQuila,,952125,62,5pughe5rcsOq3GF0utMOs5,0,66,3,3,6,3,4,7,8,0.240122,0.261132,56.843973,10,0.000586
Nickzzy,Nickzzy,,83801,53,6ddcxDK0BEkhe5LCdoA5Ki,0,66,5,3,8,7,3,10,8,0.231265,0.251135,108.326625,10,0.000789
Estani,Estani,,13180,59,4QmDIEVrROsBAad02Mlc1p,0,66,6,7,13,7,10,17,7,0.265725,0.28881,3114.050365,10,0.001357
Remik Gonzalez,Remik Gonzalez,,880668,57,4Hzj6dfl1y5x5TzCSsvLB6,0,66,1,3,4,1,6,7,9,0.179545,0.190824,791,4,0.000616
Intoxicados,Intoxicados,,863710,60,4VgvR7eu3k2T20mo6mXhXF,0,89,0,1,1,0,2,2,8,0.234718,0.248078,0,6,0.0002
El Canto Del Loco,El Canto Del Loco,,861451,62,5RK6c1tyaKpwcDpbgCGNgj,0,90,0,5,5,0,6,6,7,0.262355,0.283719,0,6,0.0002
Chano,Chano,,138189,54,14lvrkdaXxggonwjKZpePM,0,66,2,3,5,2,5,7,8,0.251033,0.267729,1021.487437,10,0.000374
Los Tipitos,Los Tipitos,,438072,52,1SykQGBiBwkQ1fcGpJ1BJt,0,66,3,7,10,4,11,15,8,0.231129,0.249373,1180.170388,6,0.000455
Oscu,Oscu,,430203,65,5iDqEobZRSTiBSAk6jLp4A,0,66,2,3,5,5,7,12,8,0.233383,0.250894,339.790953,10,0.000417
Divididos,Divididos,,835352,58,6ZIgPKHzpcswB8zh7sRIhx,0,78,1,1,2,1,1,2,8,0.230344,0.244022,85.501126,6,0.000259
Los Hermanos Rosario,Los Hermanos Rosario,,238289,50,40FzPNKgu0k9VMvvidiKCl,0,66,3,3,6,7,3,10,8,0.234352,0.252601,2392.368901,11,0.000617
Ilegales,Ilegales,,126282,51,1hMa6SwU2t8eUEETAAbk9z,0,66,2,2,4,2,2,4,7,0.241886,0.263038,809.945966,6,0.000889
La Vela Puerca,La Vela Puerca,,826253,60,6nVcjUJemqpJjc1WevwTvL,0,66,2,2,4,2,3,5,8,0.209939,0.219759,794.896438,6,0.000439
Raly Barrionuevo,Raly Barrionuevo,,164771,50,0mdD8YXAyJDJ2BHxIKF0Yf,0,66,4,1,5,5,1,6,8,0.216498,0.226899,1071.000135,6,0.000789
Simon la Letra,Simon la Letra,,103773,61,6hYxQDiGct9yfRlSEv3F8a,0,66,1,4,5,1,8,9,8,0.222097,0.242036,62.515524,10,0.000467
King Savagge,King Savagge,,98748,68,7DXregrznS25AM30UY9sUU,0,66,7,3,10,10,4,14,8,0.225328,0.24219,154.759542,10,0.001703
Jairo Vera,Jairo Vera,,188539,63,5CAruGjgds3QlF5ICtEnnc,0,66,6,3,9,10,4,14,8,0.23359,0.25351,882.554894,10,0.001872
Soto Asa,Soto Asa,,114618,58,6gyhsZUy2fzzWZBRVPmOw4,0,66,2,5,7,3,9,12,8,0.239394,0.262976,81.317596,10,0.000527
Ms Nina,Ms Nina,,141480,53,43Hr2FjhVehkROIIEb7EfQ,0,66,4,3,7,4,5,9,8,0.246567,0.267467,170.395266,10,0.000679
Los Mesoneros,Los Mesoneros,,153410,51,0OluGbRuQQEcYyttGww517,0,66,1,5,6,1,5,6,7,0.259954,0.28016,1290.264007,2,0.00029
South Park Mexican,South Park Mexican,,756343,61,4kKaAWGdu6WW0W415RWaQA,0,66,1,1,2,6,3,9,9,0.206212,0.218894,0,2,0.000288
Mr. Capone-E,Mr. Capone-E,,212113,52,3BG9cpTxZQzQChcsp7ss9a,0,66,1,4,5,2,7,9,9,0.206482,0.221215,1566,2,0.000288
King Lil G,King Lil G,,394224,55,6L3x3if9RVimruryD9LoFb,0,66,1,1,2,1,1,2,9,0.206212,0.218894,0,2,0.000288
Pepe Quintana,Pepe Quintana,,777241,53,7LXdYckhvHWU4ejXbkHa3N,0,91,0,17,17,0,29,29,7,0.300076,0.342532,0,0,0.0002
Cupido,Cupido,,81522,51,4cK5uxWRVJ3QOSfaBMX2Ex,0,66,1,2,3,1,2,3,7,0.250794,0.268737,0,2,0.000258
Foyone,Foyone,,157587,52,1F2erLLqRHbaFvEYHeVIHJ,0,66,8,12,20,16,21,37,8,0.254757,0.280426,4849.735774,10,0.001285
Pedro Guerra,Pedro Guerra,,169201,53,2GrNjfw23jqL1NTopPlc6c,0,66,2,13,15,3,17,20,7,0.275742,0.303876,1217.904145,6,0.0004
Rosana,Rosana,,733263,61,5ttV0N9HvMH3KLqNKcS2M0,0,93,0,2,2,0,3,3,8,0.245576,0.264909,0,6,0.0002
Natalie Perez,Natalie Perez,,191022,61,1Y99HOeRzRc27my6NJE3rE,0,66,5,3,8,6,5,11,7,0.264657,0.284581,2376.694153,6,0.00063
La Nueva Luna,La Nueva Luna,,720832,58,6pVmT18pd1QaofDegZUEKX,0,94,0,1,1,0,1,1,1,1,1,0,6,0.0002
Cristian,Cristian,,723578,60,3udlGv7o6NeUWRlRFGqPY9,0,95,1,0,1,2,0,2,0,0,0,0,6,0.000285
Gilda,Gilda,,715886,56,6Q6qTNC2rAegcR5QjzcRgE,0,66,2,2,4,2,2,4,8,0.230321,0.244542,917.359984,6,0.001746
Zoe Gotusso,Zoe Gotusso,,80761,52,3XBw8ImFEo86mEB2dYh0vS,0,66,5,1,6,5,1,6,9,0.187248,0.194795,245.333815,6,0.001697
Movimiento Original,Movimiento Original,,701223,60,50u2mXgysmTttY0BizYWAo,0,66,6,4,10,8,4,12,8,0.213514,0.228279,3633.075579,13,0.001479
Shamanes Crew,Shamanes Crew,,200842,50,6J9Vq69rGl3fJftWDT8jaK,0,66,1,5,6,1,6,7,8,0.220547,0.237358,802.995771,13,0.000514
Portavoz,Portavoz,,282862,52,271TPCWy79Q4utmSP6uSQg,0,5,1,1,2,1,3,4,1,1,1,27.221498,13,0.000514
Bubaseta,Bubaseta,,179456,53,7AiFAkvE8VYLDdsmLC78ik,0,66,1,1,2,1,2,3,9,0.175986,0.183814,0,13,0.000514
Natos y Waor,Natos y Waor,,677881,63,1QJbbsxg2wqidJj51d3otw,0,66,7,7,14,13,12,25,8,0.237737,0.263238,692.653911,10,0.000968
Denom,Denom,,120850,51,0fwnNjAay5ZHP5bAd63g8Y,0,66,8,18,26,11,19,30,7,0.269809,0.306823,3918.214771,13,0.001051
Maka,Maka,,377989,61,4lHAjTCvXGu8QIM3cEe93m,0,66,7,8,15,9,17,26,7,0.253124,0.281501,2272.63609,10,0.00105
El Jincho,El Jincho,,249782,55,2w1wJcGdJQ4Lw08oKBnDsw,0,66,4,4,8,6,6,12,8,0.223101,0.244551,2792.499982,13,0.000602
Dollar Selmouni,Dollar Selmouni,,67255,55,2544NCTfffschCn1NZVMSb,0,66,8,10,18,14,14,28,7,0.254346,0.281573,3007.29275,10,0.001127
Carlos Ponce,Carlos Ponce,,174706,57,4ff5IojFqry4841QjwULTV,0,66,1,1,2,1,1,2,8,0.220301,0.232908,0,7,0.000263
Viejas Locas,Viejas Locas,,664282,57,7wTu5u7W3kc9Id5JAvSAFV,0,79,1,0,1,2,0,2,0,0,0,0,6,0.000259
Jenny And The Mexicats,Jenny And The Mexicats,,207676,50,2faVKByk0IA651ICKyYYOa,0,66,1,1,2,1,2,3,9,0.183764,0.192217,0,6,0.000372
Antônio Carlos Jobim,Antônio Carlos Jobim,,542755,64,3pO5VjZ4wOHCMBXOvbMISG,0,46,2,1,3,10,9,19,1,1,1,784,12,0.001508
Daniela Spalla,Daniela Spalla,,112608,58,2VSRhqonKsL7KRAIk8SMmt,0,66,5,3,8,6,5,11,8,0.217212,0.231269,1585.353866,6,0.001038
Conociendo Rusia,Conociendo Rusia,,137919,55,79R7PUc6T6j09G8mJzNml2,0,66,1,4,5,1,5,6,8,0.218776,0.234393,148.12203,6,0.000439
Loquillo,Loquillo,,275987,52,5Fv0DQ1ZBuc2DlidtOUCZr,0,66,1,4,5,1,4,5,8,0.238815,0.256346,152.21409,6,0.000439
Generación 12,Generación 12,,422883,55,1w76rpst0I6hGUgCR2B33C,0,66,3,11,14,4,14,18,8,0.222912,0.247057,1804.036223,8,0.001157
Ingrid Rosario,Ingrid Rosario,,526564,51,39PYJNgoQuBHjE6LEn3ZdE,0,66,3,2,5,4,2,6,10,0.164241,0.175445,5.470707,8,0.000987
Musiko,Musiko,,158887,54,4A03xFVufDpEqOY9fQlFue,0,66,6,8,14,13,12,25,7,0.254265,0.281866,5664.664352,8,0.001953
Flans,Flans,,609090,59,4zbqGb99bANxJBsvwRr2zT,0,28,1,0,1,2,0,2,0,0,0,0,6,0.000257
La Gusana Ciega,La Gusana Ciega,,591088,55,4bx914GWsNvshDzfYNSKjY,0,96,0,1,1,0,1,1,9,0.178636,0.186443,0,6,0.0002
SFDK,SFDK,,586276,57,56n1NeXsTOOxjX3Z4lVMTJ,0,66,5,8,13,7,16,23,8,0.249369,0.269956,2319.377682,13,0.001073
Kaze,Kaze,,197849,53,2X11x8C63wCzAf1WwsIuLg,0,66,3,1,4,5,1,6,8,0.203924,0.215785,50.371491,13,0.000633
Green Valley,Green Valley,,251590,51,1v7iZcyrm4fHfsEBiseomy,0,66,5,8,13,6,12,18,8,0.24056,0.26022,2931.035734,13,0.001396
Morodo,Morodo,,423207,53,2OnH4HpywAxWkSOEsyjdjn,0,66,5,3,8,6,3,9,8,0.214908,0.228556,192.245398,13,0.000962
Kabasaki,Kabasaki,,4587,54,4rO00pQq33bIv73QyJdivX,0,66,10,10,20,15,21,36,7,0.26272,0.291878,3526.776272,10,0.001652
Juancho Marqués,Juancho Marqués,,138533,51,5JcO3FHEBbWTQMUHmWtU2g,0,66,7,4,11,7,4,11,8,0.231536,0.251822,159.244855,10,0.000926
Soge Culebra,Soge Culebra,,209457,53,2SNfNJDsahTSVFwgxposF5,0,66,4,7,11,5,7,12,7,0.27364,0.297851,5788.826345,10,0.00082
Tranzas,Tranzas,,586719,55,1GfaAWKfZE9hrYS8IqkWKB,0,97,0,1,1,0,1,1,8,0.230679,0.247276,0,3,0.0002
Pepe : Vizio,Pepe : Vizio,,29097,51,4rvJ0Ktz2X2Erea9XUHxfu,0,66,6,10,16,9,12,21,7,0.256327,0.284822,961.7153,10,0.000984
Cabas,Cabas,,571475,54,3W4lVkySjtIvd67UUg0F3i,0,98,0,4,4,0,5,5,8,0.247188,0.265726,0,6,0.0002
Hillsong en Español,Hillsong en Español,,570156,60,3phVKYqeq84Ai91CHTQfNq,0,99,0,4,4,0,4,4,9,0.207666,0.224241,0,8,0.0002
Las Pelotas,Las Pelotas,,568267,57,1Qv4E1VgZOGnOYd99Kp5Bs,0,100,0,1,1,0,2,2,9,0.178153,0.184403,0,6,0.0002
Ayax y Prok,Ayax y Prok,,566214,61,5Ypafuz95Xk09YDf4tgAvU,0,66,7,10,17,17,33,50,8,0.234213,0.258712,821.644395,10,0.000998
Blasfem,Blasfem,,6413,55,4FActBvkmDc8h3sI5vbMPZ,0,66,4,9,13,23,22,45,8,0.230321,0.253808,421.817146,10,0.000778
Cookin Soul,Cookin Soul,,121835,55,06s35sbFfZJUEwFjAaZfiW,0,66,5,1,6,20,5,25,9,0.182532,0.194185,33.198644,10,0.00088
Hard GZ,Hard GZ,,208444,56,79N4S7UXdjo2fAh3OHJQuB,0,66,7,5,12,22,31,53,8,0.222975,0.242505,914.463927,13,0.001058
Easy-S,Easy-S,,44260,50,4oNsvVnFz4HQ0UPpPFSuJX,0,66,10,7,17,20,26,46,8,0.222097,0.242972,896.584425,10,0.001635
Banda XXI,Banda XXI,,557742,57,4She1focTkX0pwpJUtS5eo,0,15,1,0,1,1,0,1,0,0,0,0,6,0.00026
Stan Getz,Stan Getz,,346785,62,0FMucZsEnCxs5pqBjHjIc8,0,46,1,1,2,9,9,18,1,1,1,0,12,0.00148
Karen Méndez,Karen Méndez,,530472,52,0txXDZCdXBzha20sgN1GRk,0,66,1,3,4,2,4,6,7,0.259442,0.282896,161.377374,10,0.000306
Living,Living,,71036,51,2miffAnnUvKSyB9ykA2su9,0,66,2,4,6,2,8,10,9,0.183295,0.198299,2.091667,8,0.000489
Sandra Echeverria,Sandra Echeverria,,12501,50,0LfJXLNpLGZtn4OAki9W31,0,66,1,1,2,3,2,5,8,0.224687,0.237664,27.635103,6,0.000311
Los Abuelos De La Nada,Los Abuelos De La Nada,,517003,60,5R3NywPPOyhLfdvutgg0me,0,101,0,5,5,0,9,9,8,0.229342,0.246715,0,6,0.0002
Benjamín Amadeo,Benjamín Amadeo,,90715,50,6GYXfifD78PYARjZzxQzrG,0,66,3,6,9,4,8,12,8,0.251994,0.273522,723.427097,6,0.000338
Majo y Dan,Majo y Dan,,238409,55,0cEa9u1e3cDLXCZxxiuEmi,0,66,2,3,5,2,6,8,8,0.203608,0.21891,1635.283206,8,0.001921
Tan Bionica,Tan Bionica,,506850,60,37MCoi4pcUf9EKsPXeuCqU,0,102,0,1,1,0,1,1,8,0.240134,0.253276,0,6,0.0002
La Sonora Matancera,La Sonora Matancera,,191404,55,01p7Homi0d4XxZ06f2NYYD,0,66,1,1,2,29,18,47,10,0.177568,0.184422,0,9,0.00046
Johnny Pacheco,Johnny Pacheco,,192323,50,09947uhj2ZwU9mFXK5v50o,0,66,1,1,2,3,5,8,10,0.177568,0.184422,0,9,0.00046
Rojo,Rojo,,461456,52,5NvKO965JkIJanRuKQPVN6,0,66,2,1,3,2,4,6,10,0.15588,0.16368,40.032307,8,0.000745
Los Claxons,Los Claxons,,449315,55,4AgfaZvOiSS97uy5ekQ7bf,0,66,2,2,4,5,2,7,7,0.24078,0.254864,140.565434,6,0.000304
Porter,Porter,,306865,54,7eBQrhxTHcor6gcbcLhqE5,0,66,1,2,3,2,2,4,9,0.218232,0.231694,141.763581,6,0.000541
Árbol,Árbol,,234597,52,6OO01j5rLKCyPg4i3FuzIT,0,66,1,2,3,1,2,3,8,0.215965,0.228472,13.607915,6,0.000255
Aiman JR,Aiman JR,,143194,50,4BwfloY1F2zHUPcYlYnDnz,0,66,1,2,3,1,4,5,7,0.249921,0.269599,6.425118,10,0.00037
Xtreme,Xtreme,,426404,54,47bVt95bvBMpmJFWoyhH0C,0,104,0,1,1,0,1,1,9,0.202561,0.212376,0,6,0.0002
Los Manseros Santiagueños,Los Manseros Santiagueños,,226445,52,0IAWTLWnUIzKVQDTGoYJk2,0,66,1,2,3,1,2,3,8,0.223986,0.239346,97.62265,6,0.000304
Guasones,Guasones,,411658,55,2wjmZuSHtRx96Qxb8HiP2o,0,45,1,0,1,1,0,1,0,0,0,0,6,0.00026
Golpe a Golpe,Golpe a Golpe,,404145,51,0nqpXa8bkBlWgS9FKhNCuj,0,105,0,5,5,0,9,9,7,0.273135,0.301704,0,0,0.0002
La Mosca Tse-Tse,La Mosca Tse-Tse,,403962,61,60nua3AsVSfADZtg5Hdz3W,0,106,0,1,1,0,1,1,9,0.18666,0.19487,0,6,0.0002
Rawayana,Rawayana,,398730,56,2AbQwU2cuEGfD465wCXlg2,0,66,4,5,9,5,7,12,7,0.257413,0.276519,1426.533813,2,0.000459
Los Amigos Invisibles,Los Amigos Invisibles,,373907,61,5x3mrCTZmkoTXURN7pWdGN,0,66,1,6,7,2,6,8,8,0.250873,0.272393,128.839994,6,0.000278
Yiyo Sarante,Yiyo Sarante,,395616,59,2rwLjVHS15sfzciKXXNbgA,0,66,3,3,6,3,3,6,8,0.237594,0.255815,810.384208,13,0.001219
El Roockie,El Roockie,,157999,50,3sc8HnadkPW5YaIGbCljw4,0,66,3,7,10,6,10,16,7,0.284582,0.317556,887.71663,0,0.000461
Mach & Daddy,Mach & Daddy,,103191,52,5Q1vijNjTVhQBoVrZVXms8,0,66,3,3,6,5,4,9,8,0.234074,0.250497,178.292003,2,0.000439
La Factoria,La Factoria,,297989,65,4VsbQvC84B8Z3IsBY1HLQy,0,66,2,3,5,3,5,8,8,0.204663,0.216083,7.422219,2,0.000395
Stailok,Stailok,,43440,52,3raEZI89hszEBTTvb5wLsi,0,4,3,0,3,5,0,5,0,0,0,0,13,0.000969
Yoskar Sarante,Yoskar Sarante,,374386,51,5VcamBo0Goh74iFQDqj6Q4,0,107,0,1,1,0,1,1,1,1,1,0,3,0.0002
Calo,Calo,,370195,56,2Qm12OdHFDHSpWhBMpO16L,0,108,0,1,1,0,2,2,8,0.219661,0.232031,0,6,0.0002
Adalberto Santiago,Adalberto Santiago,,118501,56,6tZxUxheS7w3953cQFOXkd,0,109,0,1,1,0,1,1,10,0.177713,0.184821,0,9,0.0002
Palabra en Acción,Palabra en Acción,,38664,50,4umfGspINdkBEwCjc1f5Xw,0,43,1,1,2,5,5,10,1,1,1,0,8,0.002763
Estelares,Estelares,,354982,56,6Nm62oNQCdPxVoiQtFSksF,0,110,1,3,4,2,3,5,8,0.237609,0.253746,375.337891,6,0.000285
Robleis,Robleis,,354242,58,32AuV4BxATEf2i7YVhIjht,0,66,1,1,2,1,1,2,8,0.209995,0.220631,0,10,0.000364
Airbag,Airbag,,342697,60,1wKDGglKV4FsFS85r2Dmpr,0,111,0,1,1,0,1,1,10,0.174614,0.182587,0,6,0.0002
Dillom,Dillom,,332419,62,4cJD9t5QBFTUQcd3xfbOb2,0,66,1,2,3,1,2,3,7,0.235962,0.254726,11.117602,10,0.000274
Saramalacara,Saramalacara,,108288,54,3QchzUOTSCKWmaRGEEiuir,0,66,4,1,5,7,2,9,8,0.200864,0.210521,21.300725,10,0.000892
Ratones Paranoicos,Ratones Paranoicos,,329345,51,5fVtUielMhdztOA34ArB6c,0,112,0,3,3,0,4,4,8,0.23626,0.251597,0,6,0.0002
La Banda Baston,La Banda Baston,,328962,51,3vV4Tf1iC8vEP9fLOLGUfP,0,113,0,2,2,0,2,2,7,0.247885,0.265445,0,2,0.0002
Grupo Limite,Grupo Limite,,317898,57,2qWNYueLfc979iEdLOIK2C,0,114,0,2,2,0,4,4,8,0.22449,0.236989,0,6,0.0002
Gloosito,Gloosito,,20849,52,1MXug5KOetEEQjjvCPWwIm,0,66,1,1,2,1,2,3,8,0.205355,0.219619,0,10,0.00026
Calero LDN,Calero LDN,,115029,50,0VD8vX2wvCYYD0SMFCZeRR,0,66,6,4,10,8,4,12,9,0.189267,0.20344,2818.171219,13,0.001706
Abhir Hathi,Abhir Hathi,,12866,65,2D8UzkIVdg1bj0Iqz6gjk0,0,66,6,4,10,7,10,17,8,0.21632,0.23377,76.2257,10,0.001123
Guayacán Orquesta,Guayacán Orquesta,,303641,59,2pZ81eCkqxemIjqqfE1fhE,0,116,0,5,5,0,5,5,8,0.255897,0.27486,0,6,0.0002
Perotá Chingó,Perotá Chingó,,296246,52,5cMTiWeaWidGI8hVoZY8Ox,0,51,1,0,1,1,0,1,0,0,0,0,10,0.000323
Arce,Arce,,295499,51,7eH1UUCyxL8Wf9PztvvPJ6,0,66,2,5,7,2,10,12,7,0.25666,0.27833,1233.14707,13,0.000366
Miranda,Miranda,,66694,50,0DjGDEVSQsodFbL1bMVPRs,0,66,3,5,8,4,6,10,8,0.212309,0.228189,778.510321,13,0.000689
Cyril Kamer,Cyril Kamer,,59202,57,3J1MhhyXLJRNRZVrx11Lbf,0,66,3,3,6,4,3,7,7,0.233521,0.254693,36.883712,10,0.000502
Skinny Flex,Skinny Flex,,103044,53,4FhC69hLxEcpLUaC08ityW,0,66,3,2,5,4,3,7,8,0.213168,0.229462,431.903896,4,0.00096
Nicho Hinojosa,Nicho Hinojosa,,292529,51,6fs2zAuQ7tpU2kGIpyouQh,0,117,0,1,1,0,1,1,8,0.20696,0.21871,0,6,0.0002
Quantic,Quantic,,289632,59,5ZMwoAjeDtLJ0XRwRTgaK8,0,31,1,0,1,1,0,1,0,0,0,0,6,0.000641
Ingratax,Ingratax,,290716,63,62YF0FglEltB3CnVIjoko8,0,66,1,1,2,1,1,2,8,0.234213,0.2514,0,2,0.000258
La Fuga,La Fuga,,284810,52,5YyScSZOuBHpoFhGvHFedc,0,120,0,2,2,0,2,2,9,0.190385,0.198576,0,6,0.0002
Celtas Cortos,Celtas Cortos,,217656,50,3hIPQBm8PBt8B5aahP6cVP,0,119,1,1,2,1,1,2,9,0.19019,0.197562,0,6,0.000285
Obie Bermudez,Obie Bermudez,,277826,52,0caLxEeeNrpE0noxdInoGe,0,121,0,2,2,0,5,5,8,0.225613,0.240762,0,6,0.0002
NB Ridaz,NB Ridaz,,263098,50,2KNDYRKdCzuKzCCUyjAcF4,0,61,1,0,1,1,0,1,0,0,0,0,2,0.000261
Fulanito,Fulanito,,263401,50,0hD97064k3LBUrRvfT42SE,0,123,2,0,2,2,0,2,0,0,0,0,11,0.000426
Laureano Brizuela,Laureano Brizuela,,238525,51,5388C04OP0Fc6xqbvct7kv,0,66,1,1,2,1,1,2,9,0.19306,0.20285,0,6,0.000503
Dani J,Dani J,,46923,51,3TEhIeweC59okLmqFu6LWv,0,41,1,0,1,1,0,1,0,0,0,0,11,0.000336
Proyecto Uno,Proyecto Uno,,253505,54,6w1XCiB8efbfnusJ2jzmvu,0,124,0,1,1,0,1,1,1,1,1,0,11,0.0002
Chusterfield,Chusterfield,,26785,51,3m6N2XBSZqfkujRvGYcdi8,0,66,2,1,3,2,1,3,9,0.19396,0.203247,0,13,0.000541
Mancha De Rolando,Mancha De Rolando,,250710,50,4DuhYdfd2jHMdaqYVYZp04,0,57,1,1,2,1,1,2,1,1,1,0,0,0.001654
JC Reyes,JC Reyes,,67543,64,0FwnPHExlRRxEZPLAi5tmG,0,66,10,8,18,19,18,37,7,0.262284,0.292185,1707.569922,13,0.001394
Kika Edgar,Kika Edgar,,248463,53,2QTmeZpVjHmIoYSRwsoucA,0,125,0,4,4,0,4,4,8,0.240791,0.25962,0,6,0.0002
Alejandro Santamaria,Alejandro Santamaria,,15998,52,7HXJp9OMIL5tdwZYleuBvy,0,66,5,7,12,5,13,18,7,0.280341,0.305741,428.141142,2,0.000528
La Raíz,La Raíz,,245667,50,036IY6CphXdsPiqIXdqvCP,0,126,0,1,1,0,1,1,9,0.173693,0.179512,0,6,0.0002
Los Huayra,Los Huayra,,180136,51,796YUyTCTkXZAZg4CLUoWl,0,129,0,3,3,0,3,3,8,0.210821,0.224279,0,6,0.0002
Nikone,Nikone,,234628,53,105iYV1T7lf8Rysxo0KzfD,0,66,4,3,7,16,16,32,9,0.186233,0.199733,95.013673,13,0.00093
Lupita's Friends,Lupita's Friends,,4931,50,7gGKjAXKRyDUhSUhFDIaAW,0,66,6,7,13,33,19,52,8,0.219079,0.240057,1427.760987,13,0.001139
Volován,Volován,,233711,50,0htSEnHjTcKdNapBwIsEaA,0,130,0,1,1,0,2,2,8,0.210037,0.221829,0,6,0.0002
Xavibo,Xavibo,,53847,50,3v2sYzsuZVd0gAhMWgl9I7,0,66,3,3,6,3,3,6,9,0.192777,0.206856,617.829308,10,0.000921
Dromedarios Mágicos,Dromedarios Mágicos,,71260,53,3UP83Ekm9Jse6j0dWZJlH9,0,66,1,1,2,1,2,3,8,0.201891,0.21327,0,2,0.000539
Sayian Jimmy,Sayian Jimmy,,41116,61,3ZfYo6sKskRv0wOyrZZdAj,0,66,3,2,5,4,3,7,9,0.199545,0.212265,25.431686,10,0.001485
Sebastián Cortés,Sebastián Cortés,,30837,50,3BCFlhrVzBKHbzBnWr13d9,0,66,1,1,2,1,1,2,8,0.214908,0.225992,0,10,0.000299
Walls,Walls,,95376,55,6tvDaHOPNWfkc9Q8IghqSR,0,66,3,3,6,4,5,9,8,0.217093,0.23097,2144.861948,10,0.000781
Luis Miguel Del Amargue,Luis Miguel Del Amargue,,206344,50,0tJDMMp9vT1q6zrPih0yFQ,0,132,0,1,1,0,1,1,9,0.192177,0.201772,0,13,0.0002
Rojuu,Rojuu,,206916,62,04mTej6RpWzBxGwhfThpIi,0,66,3,4,7,6,10,16,8,0.212881,0.228969,111.744851,10,0.000587
Orslok,Orslok,,76207,55,2TzPi0fPdqVesjZ3Y2wY43,0,66,2,2,4,2,2,4,8,0.209161,0.224079,138.708792,10,0.000465
BANDIDO,BANDIDO,,86570,55,7CSpCpNGTK9589bTi44SzE,0,66,2,5,7,4,7,11,7,0.261763,0.288791,23.697292,10,0.000365
Bruses,Bruses,,201156,57,5bRLeMl4Tnozmg9wR1pY7y,0,66,2,1,3,2,1,3,9,0.182322,0.190908,790,6,0.000705
Atomic Otro Way,Atomic Otro Way,,111393,57,05i5DIXDf4Ai4NEPEi3uBZ,0,66,2,5,7,3,6,9,8,0.235049,0.258226,162.519478,13,0.000487
Funzo & Baby Loud,Funzo & Baby Loud,,170807,58,1nwjHzOUQZsNYX8xoWiGVC,0,66,1,1,2,1,1,2,9,0.169528,0.177692,0,10,0.00042
Hens,Hens,,70347,57,3iY9PS7LxPnCVcCP7BjJOK,0,66,2,3,5,3,4,7,8,0.204082,0.218965,1611.410808,10,0.000778
Toma Tu Lugar,Toma Tu Lugar,,169945,52,7xJZNfI5Yks87tn3ebHy9h,0,135,0,1,1,0,32,32,10,0.144872,0.150617,0,8,0.0002
J.Moods,J.Moods,,4269,53,7q3hzOFspDedtkyBi1Azc8,0,66,2,3,5,14,16,30,8,0.214092,0.229403,0,10,0.000529
Granuja,Granuja,,79832,50,5KBPxIED8ejHkvhs4KCzyS,0,66,1,1,2,1,1,2,9,0.203189,0.214865,11.488889,10,0.000331
Cráneo,Cráneo,,153484,56,05aVtfDzBvg9eVu9MAZPGD,0,66,1,2,3,1,2,3,9,0.182786,0.195514,783,10,0.000291
Adassa,Adassa,,6240,64,72kqSqk124Vnl1wtT6q9Fh,0,136,0,3,3,0,3,3,8,0.245576,0.267317,0,2,0.0002
maye,maye,,127245,54,5ti5FPHgtaSf15KcUisZMt,0,63,1,0,1,1,0,1,0,0,0,0,2,0.000249
Paco Amoroso,Paco Amoroso,,123981,54,3E7NGbzUGlOjgYY8nvtijR,0,66,3,5,8,11,14,25,7,0.249842,0.271525,345.914331,10,0.000588
Paté de Fuá,Paté de Fuá,,147369,50,188pkeHUWXnROe7lFVYRRa,0,137,0,3,3,0,4,4,8,0.235979,0.253478,0,6,0.0002
Big Boy,Big Boy,,142838,57,5bVQN1TENxjVjWXNHHpflG,0,139,0,5,5,0,10,10,7,0.265882,0.293212,0,2,0.0002
Cardellino,Cardellino,,75715,56,7HFja6X48hWE58m3pQnGV0,0,66,2,3,5,2,5,7,9,0.196566,0.20905,190.46992,10,0.000684
Oro Solido,Oro Solido,,138938,51,7wLYNBd1fXGEKSLJMNnlt4,0,140,0,3,3,0,5,5,9,0.190522,0.202006,0,11,0.0002
KYOTTO,KYOTTO,,62419,50,6DGfzsM8doRBRyvYmgibkd,0,66,2,2,4,2,3,5,7,0.23788,0.256594,9.734424,10,0.000395
Axel Fiks,Axel Fiks,,31555,51,6GEaxHZNiogI175zUr4KvH,0,66,2,5,7,3,5,8,7,0.2528,0.273454,1014.839115,2,0.000442
Seguridad Social,Seguridad Social,,123757,50,5UbMQUFrcJdDstPCza7y0B,0,142,0,2,2,0,4,4,9,0.19469,0.205153,0,6,0.0002
Mayo 214,Mayo 214,,71844,50,7uXKIO6VDeOCo6ImWZpZJn,0,66,2,2,4,2,3,5,9,0.176103,0.186005,70.279211,13,0.000679
EZVIT 810,EZVIT 810,,68824,50,20taoPw3DvVajnkUySMckx,0,66,1,1,2,1,1,2,10,0.159178,0.166951,0,13,0.000562
Victor Garcia,Victor Garcia,,114572,53,4GZOqR1Cx6YeBN2Lmv0B1e,0,144,0,1,1,0,1,1,8,0.230411,0.244039,0,6,0.0002
El Bobe,El Bobe,,59861,58,3FtVhV92rZyHa7ot2ioG5a,0,66,6,6,12,7,6,13,7,0.239612,0.259406,175.198829,10,0.0009
KG970,KG970,,76119,61,6m735GSES3duQtLrgqoGUb,0,66,1,1,2,4,4,8,9,0.170039,0.177423,0,4,0.000716
La Garfield,La Garfield,,102460,51,4MT1vDqEKurI3ctpK6TqLt,0,145,0,2,2,0,3,3,10,0.166948,0.17652,0,10,0.0002
TIMØ,TIMØ,,45063,58,1KfRf4VkEYpL2G0FTWb7JX,0,66,1,1,2,1,1,2,7,0.225264,0.237288,0,2,0.00031
Juan Ingaramo,Juan Ingaramo,,62235,52,2XVoz4hoXgQ3C2BTGxl9V2,0,66,1,9,10,1,10,11,8,0.271105,0.29844,304.860821,6,0.000275
Anthrés,Anthrés,,75724,50,69euPppXM1JP7UYXzKBvi4,0,147,0,1,1,0,1,1,10,0.154372,0.160007,0,6,0.0002
Viva Suecia,Viva Suecia,,71266,52,57s0ep3eNSg81D7ZxiuHbC,0,148,0,1,1,0,1,1,9,0.192457,0.204138,0,6,0.0002
Carbon Fiber Music,Carbon Fiber Music,,8018,59,7akJAsqIpakhpXpWEUSEGX,0,153,0,11,11,0,52,52,7,0.293072,0.331575,0,0,0.0002
