id,label,interval,followers,popularity,id,componentnumber,strongcompnum,indegree,outdegree,unique_collabs,weighted_indegree,weighted_outdegree,total_collabs,eccentricity,closnesscentrality,harmonicclosnesscentrality,betweenesscentrality,modularity_class,pageranks
Bad Bunny,Bad Bunny,,52296565,100,4q3ewBCX7sLwd24euuV69X,0,22,59,47,106,228,82,310,6,0.33416,0.394832,12840.180248,0,0.008945
Bomba Estéreo,Bomba Estéreo,,969417,79,5n9bMYfz9qss2VOW89EVs2,0,22,2,3,5,2,5,7,8,0.265354,0.284921,1666.150781,5,0.000436
Rauw Alejandro,Rauw Alejandro,,12796260,89,1mcTU81TzQhprhouKaTkpq,0,22,82,35,117,234,74,308,7,0.3208,0.373693,9155.825487,0,0.008404
Jhay Cortez,Jhay Cortez,,4349987,84,0EFisYRi20PTADoJrifHrz,0,22,32,36,68,73,234,307,7,0.319886,0.373322,2552.074793,0,0.004053
Tony Dize,Tony Dize,,2972734,75,3LKXWvXFWrkwUzJWxzwVpW,0,22,18,14,32,26,122,148,7,0.294323,0.333351,472.347037,1,0.002463
Tainy,Tainy,,966906,79,0GM7qgcRCORpGnfcN2tCiB,0,22,14,18,32,62,320,382,7,0.307903,0.350908,2799.712009,0,0.00188
Daddy Yankee,Daddy Yankee,,28662176,87,4VMYDCV2IEDYJArk749S6m,0,22,72,36,108,412,115,527,7,0.317027,0.370987,6746.504992,1,0.007775
Jowell & Randy,Jowell & Randy,,3586976,69,4IMAo2UQchVFyPH24PAjUs,0,22,55,43,98,282,87,369,7,0.324038,0.380493,4246.950374,0,0.005239
Ñengo Flow,Ñengo Flow,,3529653,79,12vb80Km0Ew53ABfJOepVz,0,22,98,42,140,229,77,306,7,0.308467,0.368988,7538.644257,0,0.008498
ROSALÍA,ROSALÍA,,5555833,79,7ltDVBr6mKbRvohxheJ9h1,0,22,5,3,8,6,3,9,8,0.257154,0.283335,57.186422,0,0.001162
Mora,Mora,,583572,80,0Q8NcsJwoCbZOHHW63su5S,0,22,16,21,37,20,150,170,6,0.33499,0.376632,10906.322202,3,0.001657
El Alfa,El Alfa,,2315224,77,2oQX8QiMXOyuqbcZEFsZfm,0,22,41,35,76,61,106,167,7,0.314659,0.369825,4393.11334,0,0.005475
Ozuna,Ozuna,,32829025,85,1i8SpTcr7yvPOmcqrbnVXY,0,22,64,48,112,442,93,535,7,0.329584,0.389409,5595.080279,0,0.007179
Farruko,Farruko,,13580462,84,329e4yvIujISKGKz1BZZbO,0,22,133,68,201,345,112,457,7,0.3283,0.401081,19891.595093,0,0.012931
Arcangel,Arcangel,,8527320,80,4SsVbpTthjScTS7U2hmr1X,0,22,106,62,168,467,156,623,7,0.332347,0.402614,8480.22361,0,0.010678
DJ Luian,DJ Luian,,1544716,73,64aJYyrXljOodnUG6jvhRD,0,22,18,26,44,52,48,100,7,0.304839,0.353702,202.139587,1,0.002232
Yaviah,Yaviah,,128572,59,0Y30TbA4p8SAfCzy2AFBa8,0,22,4,1,5,4,1,5,8,0.240886,0.26138,2.359921,1,0.000759
Sech,Sech,,10971770,83,77ziqFxp5gaInVrF2lj4ht,0,22,32,27,59,89,59,148,7,0.309743,0.359068,934.331511,0,0.004405
Anuel AA,Anuel AA,,22878068,85,2R21vXR83lH98kGeO99Y66,0,22,54,45,99,235,190,425,7,0.33153,0.390766,4402.814897,0,0.006576
Prince Royce,Prince Royce,,7097558,75,3MHaV05u0io8fQbZ2XPtlC,0,22,23,17,40,36,23,59,7,0.296134,0.337258,2922.717694,1,0.002892
J Balvin,J Balvin,,34651986,87,1vyhD5VmyZ7KMfW5gqLgo5,0,22,57,27,84,421,160,581,7,0.315839,0.366437,4427.077189,0,0.00628
Bryant Myers,Bryant Myers,,7149772,75,6w9ToX5slZ4uIdmD17hJ3c,0,22,58,30,88,121,64,185,7,0.30374,0.357168,1666.308403,0,0.005661
Almighty,Almighty,,415134,70,6P6GTRTigHBp8ZesNtpCKH,0,22,43,29,72,77,38,115,7,0.297835,0.349513,19065.79128,0,0.004225
Noriel,Noriel,,6061607,72,3RtNN1VnooWEn3KQk03DUL,0,22,58,24,82,200,41,241,7,0.299157,0.345107,2956.033404,0,0.004937
Baby Rasta,Baby Rasta,,1673148,63,0GgyFUpOyzWDRDqx8FCTDN,0,22,18,34,52,33,209,242,7,0.311173,0.362724,3681.301361,0,0.001792
Brytiago,Brytiago,,5239032,72,00XhexlJEXQstHimpZN910,0,22,46,44,90,108,224,332,7,0.32218,0.381556,3300.643361,0,0.004722
Nicky Jam,Nicky Jam,,17337859,81,1SupJlEpv7RS2tPNRaHViT,0,22,100,35,135,222,88,310,7,0.314659,0.368772,6564.647951,1,0.009353
Don Omar,Don Omar,,7596396,79,33ScadVnbm2X8kkUqOkC6Z,0,22,43,29,72,275,59,334,7,0.305254,0.353875,2667.687861,1,0.004196
Duki,Duki,,6416620,84,1bAftSH8umNcGZ0uyV7LMg,0,22,54,39,93,129,72,201,7,0.320647,0.373841,26868.330746,2,0.005842
Pablo Chill-E,Pablo Chill-E,,821976,67,2XcZshqzPKm3iZcmt73R8D,0,22,34,17,51,70,30,100,7,0.278397,0.316282,7274.087357,2,0.003766
Kendo Kaponi,Kendo Kaponi,,929849,63,1WMwuNKzEFtU6pPkdtryYS,0,22,25,16,41,43,28,71,7,0.2826,0.326049,203.141166,0,0.002599
Ñejo,Ñejo,,3200016,67,2OHKEe204spO7G7NcbeO2o,0,22,50,41,91,68,194,262,7,0.313926,0.371807,5169.51805,0,0.005222
Pj Sin Suela,Pj Sin Suela,,56487,55,0AdjzZxHJ4MfbImx2rD0Df,0,22,9,9,18,8,11,19,7,0.280133,0.311421,1271.082266,0,0.001292
DJ Nelson,DJ Nelson,,984219,72,2ydZrTy8U3kOMOzx20s3dg,0,22,19,33,52,79,93,172,7,0.309316,0.363668,1626.795648,0,0.002376
Luar La L,Luar La L,,174750,64,4axKuDPr6WKcDCyh8vueTY,0,22,28,24,52,30,36,66,7,0.295355,0.343419,1524.816589,0,0.002707
Cosculluela,Cosculluela,,4756422,70,00me4Ke1LsvMxt5kydlMyU,0,22,63,27,90,95,51,146,7,0.308044,0.355903,1723.606896,0,0.00626
Myke Towers,Myke Towers,,9140387,84,7iK8PXO48WeuP03g8YR51W,0,22,94,27,121,222,35,257,7,0.304152,0.352416,3496.518485,0,0.009816
Zion & Lennox,Zion & Lennox,,6535701,78,21451j1KhjAiaYKflxBjr1,0,22,84,31,115,247,66,313,7,0.306503,0.359291,3773.444608,0,0.008376
Ivy Queen,Ivy Queen,,1833686,63,6p2442ymrT9lZEuCZJdYcH,0,22,18,14,32,20,16,36,7,0.285231,0.324636,1327.842731,1,0.001861
De La Ghetto,De La Ghetto,,6066404,81,3EiLUeyEcA6fbRPSHkG5kb,0,22,103,38,141,303,65,368,7,0.311604,0.366363,6945.266233,0,0.010639
Revol,Revol,,717226,58,2wYOpkTJZGByNEOjEnSmoW,0,22,13,15,28,13,19,32,7,0.288157,0.330956,107.854152,0,0.001987
Zion,Zion,,3073963,73,1pgDilWYDWLoOgGjf1iHNu,0,22,51,29,80,130,112,242,7,0.305115,0.356373,1697.578966,0,0.005441
"Héctor ""El Father""","Héctor ""El Father""",,500340,63,2TjgzYcbTdsZjbT9OItIeB,0,22,16,25,41,23,65,88,7,0.297835,0.341783,558.36271,1,0.001669
Kevin Roldan,Kevin Roldan,,4874621,68,1RBzGO6Nm3uyhUSxP7EDWO,0,22,26,28,54,52,116,168,7,0.318375,0.36855,4936.108226,0,0.001971
Quimico Ultra Mega,Quimico Ultra Mega,,232626,58,3tZdknQnzsVIIdaGCTj4RX,0,22,32,18,50,48,36,84,7,0.274095,0.313131,4138.742977,0,0.003494
Mark B.,Mark B.,,221737,51,0zZJhc1T0zBurhnBwQ2fcu,0,22,11,3,14,11,3,14,7,0.264417,0.291448,422.705134,0,0.001854
KAROL G,KAROL G,,26727903,86,790FomKkXshlbRYZFtlgla,0,22,18,20,38,127,83,210,7,0.309743,0.353356,2071.897526,1,0.001908
Wisin & Yandel,Wisin & Yandel,,5476493,78,1wZtkThiXbVNtj6hee6dz9,0,22,41,37,78,556,65,621,7,0.329262,0.382111,4929.762205,1,0.00418
Maria Becerra,Maria Becerra,,2834624,81,1DxLCyH42yaHKGK3cl5bvG,0,22,22,10,32,50,155,205,7,0.273317,0.305094,3705.977846,3,0.002632
Chris Jedi,Chris Jedi,,1915083,72,0qTZZWLzuD59Un5r1speHm,0,22,6,7,13,14,501,515,7,0.282245,0.319101,250.234836,0,0.000938
Maluma,Maluma,,31679634,83,1r4hJ1h58CWwUQe3MxPuau,0,22,55,43,98,265,59,324,7,0.326234,0.385898,8573.993246,5,0.005696
Tokischa,Tokischa,,164515,63,2p4aN0Uxkk3iT3HK0cJ2cJ,0,22,10,6,16,12,6,18,7,0.261038,0.291797,755.865086,0,0.002073
Wisin,Wisin,,7959899,76,3E6xrwgnVfYCrCs0ePERDz,0,22,74,53,127,174,280,454,7,0.360621,0.421874,23198.162336,1,0.007053
Yandel,Yandel,,6046630,74,0eHQ9o50hj6ZDNBt6Ys1sD,0,22,61,56,117,222,241,463,7,0.34511,0.409831,10188.497807,1,0.006485
Jay Wheeler,Jay Wheeler,,2689321,78,2cPqdH7XMvwaBJEVjheH8g,0,22,40,20,60,90,85,175,7,0.302649,0.347792,1513.912087,0,0.003846
Feid,Feid,,1695286,84,2LRoIwlKmHjgvigdNGBHNo,0,22,20,24,44,62,88,150,7,0.318827,0.365444,2914.925204,0,0.001995
Jesse & Joy,Jesse & Joy,,6461919,73,1mX1TWKpNxDSAH16LgDfiR,0,22,5,7,12,13,12,25,7,0.281655,0.310032,419.089818,5,0.000818
Juan Magán,Juan Magán,,1687332,68,1ackd5XprZEkH3McKbQD51,0,22,23,24,47,77,105,182,7,0.312326,0.359118,6150.060871,3,0.001705
Boza,Boza,,443910,68,2NfSBtmWe7oPw1EmetJVso,0,22,9,4,13,31,8,39,8,0.246706,0.273679,77.102652,3,0.000892
Romeo Santos,Romeo Santos,,15925967,78,5lwmRuXgjX8xIwlnauTZIP,0,22,16,19,35,25,37,62,7,0.292408,0.330988,8232.778668,1,0.003013
Manuel Turizo,Manuel Turizo,,9935945,79,0tmwSHipWxN12fsoLcFU3B,0,22,39,17,56,108,27,135,7,0.294195,0.337025,550.162457,3,0.004101
Anthony Santos,Anthony Santos,,727810,60,06TVTkMAOR935MhkjX0i2A,0,22,13,4,17,22,3,25,8,0.239347,0.259909,76.765445,1,0.001178
Camilo,Camilo,,15876653,80,28gNT5KBp7IjEOQoevXf9N,0,22,18,13,31,69,158,227,7,0.306782,0.340024,8119.288257,5,0.001864
Ele A El Dominio,Ele A El Dominio,,1254042,63,4SzD0wClEg9NKVJZbCRFqS,0,22,26,14,40,55,38,93,7,0.284029,0.32595,432.888796,0,0.002344
Juanka,Juanka,,596725,66,3Wb38LDP3N4tkobValgE9D,0,22,51,21,72,141,33,174,7,0.287911,0.334344,2267.57299,0,0.004263
Plan B,Plan B,,1925599,76,2jSGzJw0ebJLu7OLVSOcBP,0,22,31,17,48,56,20,76,7,0.297703,0.339236,354.106297,0,0.003682
Lunay,Lunay,,6990918,73,47MpMsUfWtgyIIBEFOr4FE,0,22,24,20,44,40,58,98,7,0.295874,0.339077,1456.213131,0,0.002984
Lyanno,Lyanno,,710772,70,1Ts9of7VPZElwPQnqnDSfW,0,22,51,24,75,193,48,241,7,0.305669,0.354359,2837.505823,0,0.004675
Natti Natasha,Natti Natasha,,8103229,75,1GDbiv3spRmZ1XdM1jQbT7,0,22,29,22,51,65,34,99,7,0.325919,0.37028,5080.698573,1,0.004601
Ovi,Ovi,,733167,66,4o0NtnL2m0lzZmEdRas1qv,0,22,9,24,33,26,31,57,7,0.323572,0.371231,2149.510127,0,0.001433
Pusho,Pusho,,594124,58,2qbEtwBVyobgpNP5KcHE9J,0,22,45,25,70,71,40,111,7,0.304152,0.35113,554.749125,0,0.003795
Alexio,Alexio,,51746,55,4Tw0VaV1ENei24iQnktjXj,0,22,25,13,38,36,24,60,7,0.297309,0.336654,94.741472,0,0.002028
Darell,Darell,,3045302,75,1TtXnWcUs0FCkaZDPGYHdf,0,22,72,38,110,233,79,312,7,0.302242,0.360011,3795.203271,0,0.007991
Luigi 21 Plus,Luigi 21 Plus,,999191,58,77GVmrLGuxNEvj2ibvT62v,0,22,39,22,61,42,50,92,7,0.294323,0.341342,601.766038,0,0.003166
Baby Rasta & Gringo,Baby Rasta & Gringo,,2674589,62,3IEvQoAohcGX7CdrbtIle7,0,22,16,31,47,168,57,225,7,0.307482,0.356952,259.51602,0,0.001144
R.K.M & Ken-Y,R.K.M & Ken-Y,,495575,62,3jFjgKOGfVLWfXX8q5wrsg,0,22,20,14,34,101,35,136,7,0.27443,0.309715,707.301488,1,0.002196
Rochy RD,Rochy RD,,636103,64,4riOEaOW5hCeqomFDBk0aP,0,22,9,11,20,19,24,43,7,0.283193,0.318458,463.322966,0,0.001011
Dalex,Dalex,,4214151,75,0KPX4Ucy9dk82uj4GpKesn,0,22,36,31,67,114,113,227,7,0.316283,0.367363,1682.568963,0,0.003734
D.OZi,D.OZi,,191168,50,7a9gFzWS5uEHtbNNgA6xyM,0,22,28,22,50,48,39,87,7,0.293299,0.340699,545.153331,0,0.002336
Benny Benni,Benny Benni,,280449,50,5gUZ67Vzi1FV2SnrWl1GlE,0,22,19,38,57,40,95,135,7,0.305115,0.362297,458.998618,0,0.002076
"Gotay ""El Autentiko""","Gotay ""El Autentiko""",,545974,60,6ieK9Ddas29reReO60on3o,0,22,29,21,50,51,90,141,7,0.302921,0.348103,711.431747,0,0.002507
Beéle,Beéle,,391273,71,7a0XAaPaK2aDSqa8p3QnC7,0,22,16,4,20,21,4,25,8,0.258634,0.285373,313.497279,3,0.001534
Lenny Tavárez,Lenny Tavárez,,1878805,80,1pQWsZQehhS4wavwh7Fnxd,0,22,45,36,81,121,161,282,7,0.306503,0.365081,2732.857702,0,0.004341
Justin Quiles,Justin Quiles,,3628451,80,14zUHaJZo1mnYtn6IBRaRP,0,22,58,38,96,223,148,371,7,0.325761,0.379889,5031.349109,0,0.005286
Trap Capos,Trap Capos,,348975,59,2pQAUIesBqfT87PaM1ijtk,0,22,2,27,29,4,76,80,7,0.303058,0.352837,214.606933,0,0.000366
Juhn,Juhn,,1023366,71,2LmcxBak1alK1bf7d1beTr,0,22,42,24,66,76,39,115,7,0.29381,0.344012,1812.275274,0,0.003937
Marc Anthony,Marc Anthony,,7591521,75,4wLXwxDeWQ8mtUIRPxGiD6,0,22,21,2,23,40,1,41,7,0.250651,0.272767,854.503514,5,0.002956
Ricky Martin,Ricky Martin,,6689123,73,7slfeZO9LsJbWgpkIoXBUJ,0,22,12,39,51,14,50,64,6,0.352142,0.405539,13133.455684,5,0.001084
Becky G,Becky G,,11880030,81,4obzFoKoKRHIphyHzJ35G3,0,22,25,23,48,51,35,86,7,0.299955,0.347919,2042.126903,1,0.002838
Randy,Randy,,272813,67,7qYeIN2r4H1kBvr0Gm9Iav,0,22,46,22,68,99,53,152,7,0.289892,0.337746,964.23532,0,0.004289
Jory Boy,Jory Boy,,1544144,65,5lFhCi03HDneWzvCxGctrT,0,22,43,28,71,74,51,125,7,0.31378,0.363544,1192.016963,0,0.003889
Blessd,Blessd,,933788,74,1TA5sGRlKUJXBN4ZyJuDIX,0,22,7,17,24,7,16,23,7,0.293554,0.33694,1692.901944,0,0.00099
Dalmata,Dalmata,,1361483,62,3jGlU8UMMo44I2xeLQ6FD3,0,22,14,13,27,26,120,146,7,0.27657,0.313834,314.693911,0,0.001283
Leslie Grace,Leslie Grace,,1193017,60,6BeO1KuAWBqFriL1mLHtNc,0,22,8,11,19,10,15,25,7,0.286687,0.320531,496.860111,3,0.00072
Yomo,Yomo,,836374,56,4myAXQmMuS1lZe8T6Y7eBg,0,22,47,19,66,74,25,99,7,0.301296,0.344899,1018.174111,0,0.003129
Alexis y Fido,Alexis y Fido,,4483556,63,7tU1VKOuxiNZwBZC6RHidA,0,22,24,39,63,45,92,137,7,0.316878,0.373396,3667.029426,1,0.002127
Farina,Farina,,319611,60,7cYik4OyfBXYV5Z2TI7p90,0,22,21,13,34,24,20,44,7,0.296916,0.334637,4458.475074,0,0.002186
J Alvarez,J Alvarez,,4713924,66,6XFITTl7cFTdopDY3lUdlY,0,22,53,33,86,123,48,171,6,0.322026,0.371612,4701.198022,0,0.004121
Pitbull,Pitbull,,9456009,82,0TnOYISbd1XYRBk9myaseg,0,22,37,27,64,75,41,116,7,0.321258,0.369503,10741.594418,1,0.005172
Tego Calderon,Tego Calderon,,3405813,69,3SUT1jjM5hzZj9TLfLZGIP,0,22,36,16,52,63,25,88,7,0.30333,0.342734,7431.391352,1,0.004385
Noriega,Noriega,,22384,58,3P4VNQLuN1qQQnL8rMaIkL,0,22,7,11,18,29,10,39,8,0.260937,0.296153,55.02768,1,0.000602
Natalia Jiménez,Natalia Jiménez,,694739,63,0j8QSBQZ9MNSGjHr1Vll1R,0,22,13,6,19,15,10,25,7,0.296394,0.327551,3434.518731,5,0.001476
Don Chezina,Don Chezina,,327295,53,1ljNTY4uIBecRJmy69UNWt,0,22,14,7,21,24,9,33,7,0.282481,0.314176,1332.912464,1,0.001399
"Franco ""El Gorilla""","Franco ""El Gorilla""",,275336,58,2biH2I1TvZlIIIc5W14oIJ,0,22,35,25,60,66,92,158,7,0.298494,0.344023,772.787502,1,0.002624
Mariah Angeliq,Mariah Angeliq,,332599,70,0KKUc4amZyvswV2YL6WTar,0,22,19,10,29,131,113,244,8,0.272323,0.310704,1087.002878,3,0.001822
CNCO,CNCO,,9014294,70,0eecdvMrqBftK0M1VKhaF4,0,22,11,7,18,14,11,25,7,0.282955,0.311714,279.57584,1,0.001065
Alberto Stylee,Alberto Stylee,,295996,54,5mgqYTU6dhKlEdi7DOy4uU,0,22,13,15,28,36,24,60,7,0.277366,0.31607,1408.062861,1,0.001247
Andy Rivera,Andy Rivera,,2511940,66,7hIqJfRYGBWWT1Qxu6Cpd2,0,22,8,18,26,24,23,47,7,0.294323,0.336852,404.519906,0,0.000718
Brray,Brray,,171908,68,1GKIlPFdcewHtpDVCQ8zmJ,0,22,68,37,105,130,177,307,7,0.321565,0.374954,7197.678893,0,0.005323
Shakira,Shakira,,24259512,85,0EmeFodog0BfCgMzAIvKQp,0,22,14,11,25,25,22,47,7,0.305115,0.342324,2193.18436,5,0.001112
Alejandro Sanz,Alejandro Sanz,,6395705,75,5sUrlPAHlS9NEirDB8SEbF,0,22,24,23,47,55,31,86,6,0.306085,0.346142,7696.719915,5,0.00189
El Cata,El Cata,,8870,53,52aHqEQZ802daFzuMHfcES,0,22,9,7,16,15,6,21,8,0.267566,0.296422,277.625378,1,0.000747
Gustavo Cerati,Gustavo Cerati,,3169471,68,1QOmebWGB6FdFtW7Bo3F0W,0,22,8,3,11,10,2,12,7,0.229721,0.245627,780.048162,5,0.001007
Carlinhos Brown,Carlinhos Brown,,133143,51,5jvQoouPSDvUEwynz5KPpv,0,22,3,3,6,3,4,7,8,0.245359,0.264383,75.697741,5,0.000434
Calle 13,Calle 13,,2717215,68,0yNSzH5nZmHzeE2xn6Xshb,0,22,7,5,12,7,10,17,7,0.250744,0.272209,480.487916,1,0.000993
Carlos Vives,Carlos Vives,,5384986,74,4vhNDa5ycK0ST968ek7kRr,0,22,20,34,54,25,65,90,7,0.350676,0.399618,10997.677052,5,0.002057
Haze,Haze,,6484,55,77iZVjeYoYSl5P0K9mIiUE,0,22,4,4,8,5,4,9,7,0.26359,0.289498,45.553032,0,0.000836
Eladio Carrion,Eladio Carrion,,1689041,78,5XJDexmWFLWOkjOEjOVX3e,0,22,45,50,95,120,116,236,7,0.33202,0.397531,13702.568149,0,0.004121
Sinfonico,Sinfonico,,111828,55,17vZy9fIIt6woqdWfc7UCy,0,22,14,10,24,44,10,54,7,0.266825,0.299467,57.953026,0,0.001675
Casper Magico,Casper Magico,,1888877,69,1fux65HMCBvfJHqlBc4Nno,0,22,38,26,64,94,49,143,7,0.307903,0.355903,1277.467265,0,0.003244
Lil Geniuz,Lil Geniuz,,13336,50,7nuTWfojdN0o8d7NGDo71U,0,22,4,2,6,7,2,9,8,0.237743,0.261023,1.604606,0,0.000658
Enrique Iglesias,Enrique Iglesias,,10846416,76,7qG3b048QCHVRO5Pv1T5lw,0,22,10,20,30,29,80,109,7,0.317176,0.361898,2969.260662,1,0.001502
"Secreto ""El Famoso Biberon""","Secreto ""El Famoso Biberon""",,378311,53,37UACiDcdzEYii0iU0QpAf,0,22,17,10,27,28,14,42,8,0.263178,0.298578,401.823498,0,0.001815
Lito Kirino,Lito Kirino,,199098,54,68w2t0wbrGnxSIUHzWs5bt,0,22,22,11,33,24,13,37,7,0.291901,0.332539,1214.056385,0,0.002502
Messiah,Messiah,,91694,55,0tR60pwxQ5WKjPxQcKoCQ7,0,22,19,9,28,19,13,32,8,0.277024,0.315006,1027.486102,0,0.002713
Darkiel,Darkiel,,1038401,62,4z19QMyPVRwbd4Fs2LisBa,0,22,31,30,61,49,56,105,7,0.298494,0.348958,583.383878,0,0.002444
Nio Garcia,Nio Garcia,,3423473,74,5hdhHgpxyniooUiQVaPxQ0,0,22,42,46,88,81,135,216,7,0.319431,0.381631,3621.916984,0,0.003723
Sebastian Yatra,Sebastian Yatra,,19541830,80,07YUOmWljBTXwIseAUd9TW,0,22,25,30,55,175,150,325,6,0.34832,0.396365,9046.103361,3,0.002294
Guaynaa,Guaynaa,,725324,68,0BqURncJM5B1BBu7UM51eq,0,22,32,13,45,195,108,303,7,0.296524,0.337124,5461.760254,3,0.003649
Mau y Ricky,Mau y Ricky,,5233974,73,2wkoKEfS6dXwThbyTnZWFU,0,22,29,18,47,67,30,97,7,0.312761,0.353649,4255.68861,3,0.002332
Alvaro Diaz,Alvaro Diaz,,195478,67,5J7rXWjtn5HzUkJ4Jet8Fr,0,22,19,19,38,45,67,112,6,0.310886,0.349357,3396.517754,0,0.00207
Reik,Reik,,7413568,77,0vR2qb8m9WHeZ5ByCbimq2,0,22,22,18,40,93,33,126,7,0.316432,0.357754,4321.225913,3,0.002104
Lalo Ebratt,Lalo Ebratt,,1737866,65,1GAymyGBvB4gQy5Z5LZ1Wj,0,22,22,12,34,110,200,310,6,0.304289,0.338254,2173.003133,3,0.001518
Llane,Llane,,57377,56,7A02nc5WKMBLqSKXxGZ4o8,0,22,9,8,17,20,16,36,7,0.283551,0.313978,2633.546438,3,0.001196
Beret,Beret,,2623712,69,0ZHPrnImGh4re3TbSNkoZl,0,22,10,5,15,19,7,26,7,0.282245,0.303974,2691.282618,3,0.000902
Cali Y El Dandee,Cali Y El Dandee,,3627559,70,5DUlefCLzVRzNWaNURTFpK,0,22,16,21,37,56,117,173,6,0.321565,0.36318,3555.629472,3,0.00127
Lary Over,Lary Over,,4424500,66,1jSjfSgDjedJdi5MoyRu78,0,22,23,21,44,36,46,82,7,0.291775,0.338116,1102.073204,0,0.002154
Nacho,Nacho,,4587649,66,2ayNSoKPCRAfjp6hQ76hRu,0,22,24,37,61,143,149,292,7,0.345641,0.396948,8329.641633,1,0.001586
Pablo Alborán,Pablo Alborán,,4485464,72,5M9Bb4adKAgrOFOhc05Y50,0,22,15,18,33,22,72,94,7,0.313197,0.353476,4397.231861,5,0.001566
Jorge Celedón,Jorge Celedón,,1448564,60,7rNbdH4pgrnwguvzxhA2Ek,0,22,9,18,27,10,20,30,6,0.306922,0.342631,5818.336526,3,0.000693
Rosario,Rosario,,664441,63,05xSLrRgGwm2nCH2SmnNMW,0,22,9,6,15,11,33,44,8,0.223772,0.239932,1036.955505,5,0.000742
Aitana,Aitana,,2125129,76,7eLcDZDYHXZCebtQmVFL25,0,22,9,36,45,19,91,110,6,0.35013,0.397552,9692.795015,3,0.000818
Paulo Londra,Paulo Londra,,17636967,79,3vQ0GE3mI0dAaxIMYe5g7z,0,22,4,3,7,8,6,14,8,0.254052,0.281678,21.806791,2,0.000466
Ken-Y,Ken-Y,,316113,62,4DYFVNKZ1uixa6SQTvzQwJ,0,22,19,12,31,111,96,207,7,0.284508,0.3224,588.240191,1,0.001906
Trebol Clan,Trebol Clan,,1402911,59,3YXpTiyVmYCfANOlnWv6vr,0,22,13,22,35,16,66,82,7,0.281302,0.326,183.437254,0,0.001195
Luis Vargas,Luis Vargas,,254673,53,6Mjbr8K3MiiRMqmFIB4zWq,0,22,5,8,13,7,15,22,7,0.266931,0.290893,880.380788,5,0.000634
El Chaval de la Bachata,El Chaval de la Bachata,,280165,53,4RnIr0AAau1SBJMbjJ9poC,0,22,2,2,4,3,3,6,8,0.211219,0.223681,56.848744,5,0.000634
Kiko Rodriguez,Kiko Rodriguez,,94912,50,1YYp1qwJ7EAitFINQ7gOKV,0,22,2,2,4,3,2,5,8,0.218194,0.231707,146.506921,5,0.000634
Juan Luis Guerra 4.40,Juan Luis Guerra 4.40,,3124043,73,3nlpTZci9O5W8RsNoNH559,0,22,25,3,28,28,4,32,7,0.245627,0.263095,852.025462,5,0.001574
Frank Reyes,Frank Reyes,,544313,56,4vQV1LCGBdYAt5rIIPjSFZ,0,22,4,1,5,7,1,8,9,0.191913,0.202006,123.190907,1,0.000876
Aventura,Aventura,,6178963,76,1qto4hHid1P71emI6Fd8xi,0,22,1,6,7,2,12,14,7,0.274095,0.301604,37.698938,1,0.000364
Monchy & Alexandra,Monchy & Alexandra,,771901,59,3rs3EOlJ8jyPpdGiQ9Mhub,0,22,4,1,5,5,1,6,9,0.198937,0.210026,508.268754,0,0.000829
Elvis Martinez,Elvis Martinez,,232108,50,66U02qGDesTqZImnLSiYeE,0,22,1,1,2,2,1,3,8,0.228707,0.245908,4.66067,1,0.000364
Julio Iglesias,Julio Iglesias,,2192504,67,4etuCZVdP8yiNPn4xf0ie5,0,22,3,8,11,5,8,13,6,0.286565,0.314441,1089.792261,1,0.000488
Mala Rodríguez,Mala Rodríguez,,473340,58,3Ces1OJeGOVGcUB0wPaPXJ,0,22,11,7,18,39,31,70,7,0.264833,0.28901,4004.770712,3,0.002731
Nicki Nicole,Nicki Nicole,,3064024,77,2UZIAOlrnyZmyzt1nuXr9y,0,22,13,12,25,19,18,37,7,0.298759,0.334128,7171.753099,2,0.001342
Pedro Capó,Pedro Capó,,1507684,68,4QVBYiagIaa6ZGSPMbybpy,0,22,24,5,29,45,11,56,7,0.296524,0.324064,3015.297264,5,0.002003
Camilo Sesto,Camilo Sesto,,3051494,64,2Cy7KBSkqu7otJfuMTWT7Y,0,22,2,3,5,101,5,106,7,0.251774,0.274117,142.274022,5,0.000406
Camilo Séptimo,Camilo Séptimo,,442576,60,6hQHiviB4JUWVmfykjYzcB,0,22,1,3,4,47,4,51,8,0.214513,0.226676,0,5,0.000354
Ximena Sariñana,Ximena Sariñana,,1256200,64,7plUpXSFcSJUZSiZAoXqr1,0,22,16,4,20,26,4,30,7,0.238584,0.25455,2251.99709,5,0.002401
Carlos Rivera,Carlos Rivera,,3621638,72,39yVoqm6sYFvvqF1RciUVf,0,22,26,28,54,42,50,92,7,0.319734,0.368956,15634.925102,5,0.002351
Porter,Porter,,305615,54,7eBQrhxTHcor6gcbcLhqE5,0,22,2,2,4,3,2,5,7,0.258833,0.279582,665.684867,5,0.000505
Rvssian,Rvssian,,1902344,72,1fctva4kpRbg2k3v7kwRuS,0,22,4,10,14,10,21,31,7,0.28511,0.323601,4.215415,0,0.000793
Tempo,Tempo,,855273,54,76whng5pl9msPkkjFUtWYn,0,22,20,11,31,30,13,43,7,0.283312,0.322612,1129.472923,0,0.002049
Jadiel,Jadiel,,1076420,52,1K0lOPFlbPF3Volp5qIYNw,0,22,5,6,11,5,10,15,8,0.268526,0.302494,52.903157,0,0.000568
José Feliciano,José Feliciano,,294769,61,7K78lVZ8XzkjfRSI7570FF,0,22,11,2,13,14,5,19,8,0.205488,0.216707,1808.36541,5,0.001093
Pacho El Antifeka,Pacho El Antifeka,,166632,51,03Enzet8KLMkjdeQnbqbmn,0,22,21,41,62,26,63,89,7,0.314953,0.369835,2753.066982,0,0.002097
Dímelo Flow,Dímelo Flow,,311652,72,3fZk3Gm5dN5v5yfYMQ04Bx,0,22,8,47,55,29,161,190,7,0.32878,0.389381,1258.826642,0,0.001295
Jerry Rivera,Jerry Rivera,,1392847,64,7wOZy3KdFVVINgNFFxkxwO,0,22,5,3,8,15,4,19,8,0.261139,0.287415,539.165997,0,0.000738
Miky Woodz,Miky Woodz,,2973103,70,1pf0MPKfKdvS8J779mS1Ay,0,22,62,36,98,119,61,180,7,0.319734,0.374301,4765.328821,0,0.006776
Ankhal,Ankhal,,125135,59,6NmMI7UnfmIpLRYoz8H9jm,0,22,9,15,24,9,20,29,7,0.292281,0.333909,77.010265,0,0.001113
Mozart La Para,Mozart La Para,,371359,56,0odliLZMTk45CEVzF3Zocl,0,22,25,18,43,32,81,113,7,0.302513,0.345888,4150.196709,0,0.002349
Voltio,Voltio,,723346,55,3Okcq0dqLVlEFHRZ5t22bA,0,22,25,15,40,38,18,56,8,0.272433,0.309146,1303.349764,1,0.002979
Hozwal,Hozwal,,88127,51,1lgtR3WlcFxEy6yPoOh0J2,0,22,17,28,45,15,33,48,7,0.289519,0.3406,2423.12487,0,0.001494
India Martinez,India Martinez,,799281,62,6FOpWOxsjQxKEbLiJpU1xV,0,22,19,8,27,28,10,38,7,0.269384,0.295641,2988.762518,5,0.002068
Fuego,Fuego,,248346,66,7wU2WGCJ8HxkekHHE2QLul,0,22,21,22,43,42,38,80,7,0.316283,0.360195,4294.761035,3,0.002216
Reykon,Reykon,,3060926,61,3PAwspMN27PDm81WwXDsMf,0,22,16,26,42,15,44,59,7,0.326392,0.373283,3116.747084,1,0.001055
KEVVO,KEVVO,,443834,63,4QrBoWLm2WNlPdbFhmlaUZ,0,22,29,20,49,44,81,125,7,0.301431,0.345468,986.898295,0,0.002739
Cazzu,Cazzu,,4764272,73,6w3SkAHYPsQ1bxV7VDlG5y,0,22,32,27,59,103,114,217,7,0.304564,0.353925,7656.059674,0,0.002926
Jon Z,Jon Z,,4492588,70,5bWUlnPx9OYKsLiUJrhCA1,0,22,64,37,101,127,97,224,7,0.32218,0.376339,7567.976078,0,0.007485
Joyce Santana,Joyce Santana,,89406,55,4zOhMWD0LoBe2nP7s9cHhX,0,22,16,23,39,38,36,74,7,0.301566,0.347495,517.843873,0,0.001286
Julieta Venegas,Julieta Venegas,,1709640,75,2QWIScpFDNxmS6ZEMIUvgm,0,22,23,5,28,30,8,38,8,0.214036,0.226738,825.553374,5,0.002682
Emmanuel,Emmanuel,,2185685,66,2DmYtFBKcxb3ajwWWgA576,0,22,5,11,16,9,12,21,7,0.282955,0.311036,2074.720619,5,0.000575
Alex Rose,Alex Rose,,2980429,70,2DspEsT7UXGKd2VaaedgG4,0,22,33,35,68,51,76,127,7,0.320495,0.375102,6954.138621,0,0.003191
Gigolo Y La Exce,Gigolo Y La Exce,,470031,62,7lCRuW6BSXGAsxuQV9lR0i,0,22,22,23,45,39,38,77,7,0.298759,0.347721,428.968586,0,0.001799
Descemer Bueno,Descemer Bueno,,42599,64,5luyt0SUvGkDMY4ILP6Qhl,0,22,9,8,17,23,12,35,7,0.270032,0.294765,1840.724122,1,0.000844
Gente De Zona,Gente De Zona,,1465851,70,2cy1zPcrFcXAJTP0APWewL,0,22,28,14,42,61,35,96,6,0.305808,0.340579,3978.897478,1,0.001921
Luny Tunes,Luny Tunes,,1361404,60,5pZE9tgrhmIGWAsJZ7YxNK,0,22,6,17,23,8,522,530,7,0.292281,0.332486,211.164163,1,0.000415
Gilberto Santa Rosa,Gilberto Santa Rosa,,2118655,67,27vNK840zYq6IfDijHPsv1,0,22,27,9,36,24,13,37,7,0.27657,0.301215,3051.082851,5,0.001548
Luis Fonsi,Luis Fonsi,,10458133,75,4V8Sr092TqfHkfAA5fXXqG,0,22,17,20,37,30,93,123,7,0.317176,0.362032,5477.473599,1,0.001445
Aleks Syntek,Aleks Syntek,,1244054,64,0r8toju2ecKaVtItkzAnNi,0,22,17,10,27,26,29,55,7,0.282126,0.313978,6699.193325,5,0.00174
Noel Schajris,Noel Schajris,,981348,56,2uEjXyVi0SA1HPpj3zquXh,0,22,11,7,18,20,10,30,7,0.269169,0.296114,1046.887845,3,0.000967
David Bisbal,David Bisbal,,3981434,70,5gOJTI4TusSENizxhcG7jB,0,22,15,12,27,34,43,77,6,0.306085,0.340282,2070.098343,3,0.00132
Víctor Manuelle,Víctor Manuelle,,1440450,63,4N5fp4zhTsVITZTVfsXpc2,0,22,22,18,40,37,24,61,6,0.313488,0.354228,2594.830696,1,0.001817
Paty Cantú,Paty Cantú,,2044880,62,7K9rdoOJSiKXoVXPlSkGKT,0,22,12,14,26,26,45,71,7,0.306782,0.343055,3652.546067,5,0.001094
Laura Pausini,Laura Pausini,,2060829,69,2e4nwiX8ZCU09LGLOpeqTH,0,22,10,7,17,13,12,25,7,0.279089,0.305702,1202.203987,5,0.000752
Ricardo Arjona,Ricardo Arjona,,9460924,75,0h1zs4CTlU9D2QtgPxptUD,0,22,2,3,5,4,2,6,7,0.245537,0.26218,66.069224,5,0.00043
Trina,Trina,,921984,55,4PrinKSrmILmo0kERG0Ogn,0,22,3,1,4,4,1,5,8,0.243233,0.261843,10.891266,1,0.000423
Don Miguelo,Don Miguelo,,210462,56,1noWnd8QFQD9VLxWEeo4Zf,0,22,10,16,26,9,36,45,7,0.283431,0.32559,629.245792,0,0.001133
"Tito ""El Bambino""","Tito ""El Bambino""",,3167911,67,5fJsY7afrbsyzJj9wdzJMh,0,22,33,42,75,41,88,129,7,0.32529,0.383757,7134.22257,0,0.003057
Abraham Mateo,Abraham Mateo,,1401940,63,2bxxlINUlcMQQb39K7IopR,0,22,10,10,20,45,18,63,7,0.291019,0.325367,1571.175414,3,0.000904
Amarion,Amarion,,67437,52,7Bb4i0RT3zaudzb8KvxTUQ,0,22,13,31,44,12,47,59,7,0.310028,0.362396,903.572395,0,0.001266
Amenazzy,Amenazzy,,2214665,63,6kq4GHwUcUojGIu0ziSNXf,0,22,22,24,46,29,44,73,7,0.308749,0.357807,1524.72971,0,0.001911
Yaga & Mackie,Yaga & Mackie,,413158,60,16Juw2gfa9IxEL3Vu69cH7,0,22,9,27,36,9,108,117,7,0.293043,0.344853,750.671568,0,0.000798
Kiko el Crazy,Kiko el Crazy,,81331,59,3NpG6SsHaQETkdQVZH6V1E,0,22,28,17,45,44,27,71,8,0.284508,0.331203,1063.662894,0,0.002921
Omy de Oro,Omy de Oro,,196671,60,65jIUih0ZeTUJhSTRuYxpi,0,22,16,15,31,26,26,52,7,0.288034,0.330055,182.283314,0,0.001735
Cauty,Cauty,,847513,59,2QUvtLq6oQaX0LNsYY2fas,0,22,25,32,57,135,51,186,7,0.299955,0.354621,1842.824116,0,0.001983
Piso 21,Piso 21,,8278171,73,4bw2Am3p9ji3mYsXNXtQcd,0,22,13,14,27,18,28,46,7,0.302107,0.341737,1677.553616,3,0.001274
Micro TDH,Micro TDH,,1297460,67,1aWJsBQa67l72j1VT3D6Ow,0,22,8,10,18,19,23,42,7,0.306782,0.341285,1281.550971,0,0.000842
KHEA,KHEA,,4265802,74,4m6ubhNsdwF4psNf3R8kwR,0,22,28,25,53,62,142,204,7,0.314073,0.362618,7731.177095,2,0.003091
Fonseca,Fonseca,,2345363,67,53KTldaJ8tHSkYU3nigfwP,0,22,15,14,29,28,23,51,6,0.299556,0.335287,6375.787772,3,0.001241
Maikel Delacalle,Maikel Delacalle,,398552,60,2t7vyRN71qtQT18frElAnV,0,22,14,11,25,27,46,73,8,0.281655,0.317433,3199.055521,3,0.002077
Maná,Maná,,8220428,76,7okwEbXzyT2VffBmyQBWLz,0,22,2,6,8,1,8,9,7,0.282126,0.310721,157.384762,1,0.000262
Alejandro Fernández,Alejandro Fernández,,5794046,75,6sq1yF0OZEWA4xoXVKW1L9,0,22,14,7,21,22,21,43,7,0.293682,0.321676,2104.169682,3,0.001404
Chimbala,Chimbala,,431284,67,4VVEpEhC8NcR7AqNEds42U,0,22,15,24,39,58,36,94,7,0.296524,0.344669,2857.325385,0,0.001514
Kany García,Kany García,,1601196,69,69UypehHabb68utzfjAVlV,0,22,12,19,31,15,24,39,6,0.318526,0.35774,7073.233002,5,0.001665
Los Legendarios,Los Legendarios,,75832,68,0n6sKrG0xKAf8xmdqeNGke,0,22,1,7,8,22,15,37,7,0.289395,0.321729,1.870741,1,0.000337
Alejo,Alejo,,22058,69,50sIhX3HytFEwQXZJLUZQE,0,22,1,7,8,2,19,21,7,0.264314,0.290519,1084.425152,0,0.000337
Franco De Vita,Franco De Vita,,4065485,67,4NEYQeEYBUjfaXgDQGvFvu,0,22,12,20,32,18,31,49,6,0.314512,0.357072,12835.328994,5,0.001096
Nelly Furtado,Nelly Furtado,,3220620,73,2jw70GZXlAI8QzWeY2bgRc,0,22,7,8,15,8,12,20,7,0.264937,0.289621,600.963368,3,0.000951
Hector & Tito,Hector & Tito,,684661,58,5aB4SpKYteOJ8pAleoKkg7,0,22,10,16,26,15,39,54,7,0.280483,0.316773,105.671778,1,0.000584
Angel Y Khriz,Angel Y Khriz,,858671,63,7npqy7rgdX2D3yfVyWExKo,0,22,13,12,25,15,100,115,7,0.279552,0.318419,843.484009,1,0.001112
John Eric,John Eric,,63995,57,0IUvQ8DrCymt5IHywZsda2,0,22,11,4,15,100,4,104,8,0.248984,0.274283,20.455753,1,0.001257
Morat,Morat,,6244168,81,5C4PDR4LnhZTbVnKWXuDKD,0,22,15,12,27,165,35,200,6,0.314219,0.345846,3552.030088,3,0.001359
Ana Mena,Ana Mena,,492526,70,6k8mwkKJKKjBILo7ypBspl,0,22,11,9,20,14,9,23,8,0.285835,0.318306,2247.174313,3,0.000818
Sin Bandera,Sin Bandera,,4828597,69,7xeM7V59cA1X8GKyKKQV87,0,22,6,3,9,9,4,13,7,0.265773,0.290017,374.320938,5,0.000648
Tommy Torres,Tommy Torres,,849446,61,264nbMzGPSkDZqTY8nXwCG,0,22,9,8,17,16,10,26,7,0.287053,0.316769,1296.590557,5,0.000848
Maite Perroni,Maite Perroni,,1137500,68,6ModsWtBph2rE6zCTVxvZt,0,22,4,5,9,6,7,13,7,0.284628,0.313035,460.119214,3,0.000429
DaniLeigh,DaniLeigh,,1008607,61,0XIKGBo9PnK1ApI5tZA60d,0,22,3,2,5,5,4,9,8,0.25511,0.280426,215.88297,0,0.000521
ChocQuibTown,ChocQuibTown,,613489,56,6tkyhGe9hGI3Lcfo4gVh6Z,0,22,6,16,22,13,28,41,7,0.309174,0.349732,681.126662,3,0.00081
Chanell,Chanell,,18938,51,5cDfQlhT80II3f2ECXm6oA,0,22,4,7,11,7,9,16,7,0.26421,0.295637,133.525582,0,0.000624
Juan Gabriel,Juan Gabriel,,6757359,73,2MRBDr0crHWE5JwPceFncq,0,22,8,12,20,31,20,51,7,0.298098,0.3331,4646.738073,5,0.000875
Juanes,Juanes,,3920771,73,0UWZUmn7sybxMCqrw9tGa7,0,22,26,8,34,92,15,107,7,0.297966,0.324495,4483.518078,3,0.002863
Natalia Lafourcade,Natalia Lafourcade,,3413844,72,1hcdI2N1023RvSwLzTtdsp,0,22,22,17,39,47,29,76,7,0.280716,0.316239,11704.873767,5,0.003379
Alejandra Guzman,Alejandra Guzman,,3014082,66,7Hf9AwMO37bSdxHb0FBGmO,0,22,5,7,12,31,21,52,7,0.290643,0.323213,1544.903421,3,0.000585
Thalia,Thalia,,4050366,69,23wEWD21D4TPYiJugoXmYb,0,22,9,22,31,8,34,42,7,0.327502,0.371591,4888.896843,1,0.000599
Gloria Estefan,Gloria Estefan,,624168,64,5IFCkqu9J6xdWeYMk5I889,0,22,5,4,9,9,9,18,8,0.250558,0.272573,470.461481,5,0.000592
Celia Cruz,Celia Cruz,,471580,64,2weA6hhVqTIN2gSn9PUB9U,0,22,19,10,29,97,38,135,8,0.215818,0.231938,2728.836621,5,0.002964
Olga Tañón,Olga Tañón,,718852,60,4pv1Jo4PbYI8LMADJoTWjE,0,22,7,8,15,5,7,12,7,0.293554,0.324661,1032.178825,1,0.000508
Ricardo Montaner,Ricardo Montaner,,5033178,68,4uoz4FUMvpeyGClFTTDBsD,0,22,7,7,14,7,15,22,7,0.288775,0.319305,566.320737,3,0.000542
Alicia Villarreal,Alicia Villarreal,,663812,60,6Hf2g14O2TP25JUNZuvIgn,0,22,2,4,6,1,13,14,7,0.258436,0.281203,458.440724,5,0.000246
José José,José José,,5081891,73,4mN0qcMxWX8oToqfDPM5yV,0,22,5,9,14,11,31,42,7,0.258535,0.28286,3638.256786,5,0.001359
Chayanne,Chayanne,,6346212,70,1JbemQ1fPt2YmSLjAFhPBv,0,22,2,4,6,3,5,8,7,0.286687,0.313466,292.882184,5,0.000352
Paulina Rubio,Paulina Rubio,,2389591,66,1d6dwipPrsFSJVmFTTdFSS,0,22,5,5,10,18,16,34,7,0.290768,0.318189,531.355985,3,0.000576
La Ley,La Ley,,1284511,63,1ZVoRDO29AlDXiMkRLMZSK,0,22,4,2,6,2,1,3,8,0.20449,0.214349,144.476083,5,0.000286
Ana Bárbara,Ana Bárbara,,1011181,64,43qxAkuKFB6fMNSeS5dO7Z,0,22,3,10,13,3,10,13,7,0.262563,0.28906,3563.656639,5,0.00051
Gian Marco,Gian Marco,,1165022,61,2gDqGAadPIPiA7LtmNn74g,0,22,9,7,16,8,9,17,7,0.277595,0.308376,1516.407857,5,0.000642
Yuri,Yuri,,1912973,64,4OgNARLQSC4yy7Dsa5cqxx,0,22,9,11,20,15,89,104,6,0.299024,0.332245,2866.802428,5,0.001437
Miguel Bosé,Miguel Bosé,,2114624,68,7mWCSSOYqm4E9mB7V4ot6S,0,22,13,21,34,38,32,70,6,0.319734,0.362463,5108.382805,5,0.001391
José Luis Rodríguez,José Luis Rodríguez,,823334,59,15YnmlNukYCFvwaFnoDwwV,0,22,7,7,14,17,12,29,7,0.275552,0.302042,1551.25767,5,0.000866
Ha*Ash,Ha*Ash,,6645390,72,5xd2Tg7Zo8755eCy8Gxkp8,0,22,9,8,17,14,11,25,6,0.294709,0.325074,1167.930745,5,0.000652
Matisse,Matisse,,851617,69,77aLk6J8ofnVxa1eXK9jiU,0,22,11,9,20,15,9,24,7,0.273428,0.302342,2356.94304,3,0.002787
Río Roma,Río Roma,,2442815,68,2O3v9rCTzLhPFaGaAVgZLt,0,22,6,17,23,7,27,34,7,0.309458,0.347679,1036.0925,5,0.000457
Kalimba,Kalimba,,1794206,60,4RjamFQJNT8nVbTKXJDJgv,0,22,6,3,9,7,6,13,7,0.264729,0.286831,602.717209,3,0.000636
Axel,Axel,,1317589,57,32x1uogH2zajP85pzZAtuE,0,22,6,12,18,6,15,21,7,0.300223,0.335142,1878.154555,5,0.000682
Danny Ocean,Danny Ocean,,4196788,78,5H1nN1SzW0qNeUEZvuXjAj,0,22,8,4,12,9,7,16,8,0.267142,0.293173,312.157224,3,0.001196
Quevedo,Quevedo,,308484,83,52iwsT98xCoGgiGntTiR7K,0,22,7,2,9,10,2,12,9,0.218973,0.233777,1266.127163,2,0.000721
Emilia,Emilia,,825757,72,0AqlFI0tz2DsEoJlKSIiT9,0,22,8,7,15,16,10,26,7,0.275552,0.308196,701.275022,2,0.000654
Bizarrap,Bizarrap,,6150553,86,716NhGYqD1jl2wI1Qkgq36,0,22,13,47,60,21,49,70,7,0.313926,0.376402,8314.018761,2,0.001248
Rels B,Rels B,,3855968,78,2IMZYfNi21MGqxopj9fWx8,0,22,12,13,25,14,13,27,7,0.279089,0.316663,3208.089865,2,0.001262
YSY A,YSY A,,1041520,70,2qWK8K2Jfh67UqtwY8tCW6,0,22,12,13,25,18,18,36,8,0.272985,0.307924,531.388744,2,0.001291
Rei,Rei,,147755,68,4IG1SDlwgNKzqTmjBrvY3K,0,22,5,20,25,8,84,92,7,0.327981,0.372121,2381.427684,3,0.000703
C.R.O,C.R.O,,974380,69,4puAp107dCehraE47QXVQX,0,22,23,22,45,40,21,61,7,0.285957,0.325353,5096.507864,2,0.001739
Ak4:20,Ak4:20,,496046,67,1SiLK8gdECx2iEm2SSj0Bl,0,22,4,5,9,4,5,9,8,0.25434,0.282069,185.712498,2,0.00082
DrefQuila,DrefQuila,,948138,61,5pughe5rcsOq3GF0utMOs5,0,22,6,5,11,5,6,11,8,0.25973,0.289625,124.471893,2,0.000829
Asan,Asan,,103806,57,6Nl4VXcX86fBMO4YE6oYfN,0,22,6,9,15,12,11,23,7,0.276456,0.305981,455.78601,2,0.000906
Neo Pistea,Neo Pistea,,974181,62,01m2XZ7m7rAz6KY3scTdaV,0,22,30,23,53,71,28,99,7,0.300357,0.346718,4558.930475,2,0.00248
Obie Wanshot,Obie Wanshot,,27254,54,48vP5SxlTO6yOI7SLKIOQV,0,22,9,4,13,11,8,19,8,0.253574,0.278684,49.791058,2,0.001091
C. Tangana,C. Tangana,,2085761,75,5TYxZTjIPqKM8K8NuP9woO,0,22,17,20,37,56,23,79,7,0.318676,0.35615,12973.577919,2,0.002485
Leebrian,Leebrian,,29932,53,40lro6xpFS9TxV2uC7yvs4,0,22,3,14,17,2,20,22,7,0.287911,0.328522,212.878751,0,0.00044
Lara91k,Lara91k,,29850,50,2zPvDg6LI6NHPQVQIESjfW,0,22,8,5,13,14,4,18,8,0.244203,0.266101,2567.82374,0,0.001617
Mesita,Mesita,,196912,61,2IKdK6PbitvCiXt1t2bPU6,0,22,4,9,13,5,14,19,7,0.277709,0.309305,1220.128998,2,0.00061
Lucho SSJ,Lucho SSJ,,293557,59,1OBizG9nrnHJkrL9NjnWYN,0,22,10,19,29,6,23,29,8,0.272985,0.307454,902.307097,2,0.00064
Julianno Sosa,Julianno Sosa,,212172,69,4IC2X34tZmHG3VfTbpzvwL,0,22,8,6,14,22,11,33,8,0.233784,0.258865,569.806533,2,0.001229
Young Cister,Young Cister,,194622,67,0Yg29FX1M4ayqjXs0ttZFq,0,22,7,7,14,23,13,36,8,0.25434,0.281518,100.361334,2,0.001122
Tobi,Tobi,,131989,52,6H70hylNqfc86Omz8GoyDB,0,22,8,2,10,6,1,7,9,0.185063,0.19627,11.04259,2,0.00157
CA7RIEL,CA7RIEL,,148181,54,348pk4o3EhKmsSahzuClSf,0,22,10,2,12,7,9,16,9,0.170374,0.177686,79.83316,2,0.001233
Kidd Keo,Kidd Keo,,2217139,69,0VZrPa7mWAYXH4CwmYk8Km,0,22,5,7,12,18,9,27,8,0.255787,0.285253,574.515414,2,0.000694
Vicentico,Vicentico,,1386600,64,25THA9HUHoxpCT4LBp7UsZ,0,22,17,3,20,16,12,28,9,0.180118,0.189514,847.764753,5,0.001291
Marcianos Crew,Marcianos Crew,,161682,51,0Hkx0YcHHxDRRbH9WsSW0I,0,22,6,11,17,3,13,16,8,0.253288,0.279476,214.732295,2,0.000579
Frijo,Frijo,,598505,57,4D2d63igYEdzhzFnxrSow7,0,22,7,18,25,3,18,21,8,0.27589,0.312869,458.765399,2,0.000469
Bebe,Bebe,,426557,57,2byU53ebtTxcAnIRE814Ts,0,22,9,2,11,11,7,18,8,0.251211,0.271524,285.303045,5,0.00092
Belinda,Belinda,,1473593,69,5LeiVcEnsZcwc133TUhJNW,0,22,13,1,14,74,3,77,8,0.243409,0.262214,208.052934,3,0.001269
Hombres G,Hombres G,,3136312,69,60uh2KYYSCqAgJNxcU4DA0,0,22,3,3,6,3,4,7,8,0.249815,0.271515,75.39988,5,0.000555
La Oreja de Van Gogh,La Oreja de Van Gogh,,2911303,70,4U7lXyKdSf1JbM1aXvsodC,0,22,4,7,11,7,6,13,7,0.259131,0.284527,695.507071,5,0.000763
Macaco,Macaco,,403093,60,7mUBMaZW1MXGswaneb0JTT,0,22,6,16,22,8,20,28,7,0.311029,0.345899,6462.858513,5,0.000676
Marta Sánchez,Marta Sánchez,,319294,62,368rTiMKMrz3b03az6B14w,0,22,5,5,10,11,5,16,7,0.254436,0.278215,425.65519,3,0.000696
Jarabe De Palo,Jarabe De Palo,,1329141,66,5B6H1Dq77AV1LZWrbNsuH5,0,22,3,4,7,3,5,8,8,0.224368,0.240527,213.062725,5,0.000495
Vanesa Martín,Vanesa Martín,,956509,64,5kSJMVPcTITrSZxTrHllVN,0,22,16,10,26,22,13,35,7,0.289519,0.320266,3179.378642,5,0.001872
Dani Martín,Dani Martín,,769525,63,3AIPhNgeF9S1Kyg9Yy3UQW,0,22,15,6,21,28,12,40,7,0.261646,0.284796,1292.685538,5,0.001434
Manuel Carrasco,Manuel Carrasco,,1859523,65,7qAoXV4U0qDxQAUqhszjAA,0,22,6,5,11,10,18,28,7,0.272103,0.300011,59.357857,5,0.000578
Danna Paola,Danna Paola,,3886599,72,5xSx2FM8mQnrfgM1QsHniB,0,22,9,13,22,56,45,101,7,0.303058,0.335697,4732.790838,3,0.000911
Cami,Cami,,738407,63,3VCrybIJKH7UurbDcZbMmn,0,22,5,14,19,15,72,87,7,0.309316,0.346973,2163.217012,5,0.000848
Andrés Cepeda,Andrés Cepeda,,2456524,63,49Z1AvGeUaBSanPaOmplK6,0,22,11,11,22,16,23,39,7,0.295744,0.326226,1370.173158,3,0.000799
Alvaro Soler,Alvaro Soler,,1593423,70,2urF8dgLVfDjunO0pcHUEe,0,22,4,4,8,11,16,27,7,0.263487,0.286396,276.106469,3,0.00077
Lola Indigo,Lola Indigo,,773948,67,3bvfu2KAve4lPHrhEFDZna,0,22,8,15,23,21,185,206,7,0.304839,0.342673,3343.842284,3,0.001417
"Héctor Acosta ""El Torito""","Héctor Acosta ""El Torito""",,684638,57,4TCAAIMmeZXCTVlHUsicOn,0,22,9,9,18,8,12,20,7,0.27623,0.305899,701.158854,1,0.000724
Tiago PZK,Tiago PZK,,2204895,79,5Y3MV9DZ0d87NnVm56qSY1,0,22,14,5,19,25,6,31,8,0.227012,0.249163,3000.326522,2,0.004075
Snow Tha Product,Snow Tha Product,,529077,63,3p3jPcp8b7WL9XYj4xlsWj,0,22,11,2,13,11,2,13,8,0.255303,0.283022,136.672882,2,0.001065
Ptazeta,Ptazeta,,107918,62,5UN0rzL594mWY2RbOtZqIN,0,22,6,2,8,7,2,9,8,0.243058,0.260423,1202.024921,2,0.000646
Trueno,Trueno,,3611515,73,2x7PC78TmgqpEIjaGAZ0Oz,0,22,6,7,13,7,11,18,7,0.278282,0.311262,783.610361,2,0.000548
Dani Ribba,Dani Ribba,,335424,60,6cC67GpmPCjQjOYLpmOGhN,0,22,7,2,9,11,2,13,8,0.243497,0.265013,22.755287,2,0.000683
Chucky73,Chucky73,,135821,59,38epWdyauFwdRkldqUMfWE,0,22,10,10,20,11,29,40,7,0.284388,0.322972,306.425,0,0.000965
ZARAMAY,ZARAMAY,,170412,56,3wsYquQ9CiMlYG54BUR2ff,0,22,9,9,18,7,9,16,8,0.271884,0.306367,2424.585085,2,0.000837
Big Soto,Big Soto,,789233,66,2TQ4CGgxxCWHqa9yYIGDoU,0,22,26,27,53,82,78,160,7,0.315543,0.366264,5310.013386,0,0.001652
Neutro Shorty,Neutro Shorty,,653252,62,5wUO3A6DT4tO5UDz21kE2Y,0,22,14,10,24,49,19,68,7,0.291145,0.329299,2876.225291,0,0.001255
Dillom,Dillom,,329161,62,4cJD9t5QBFTUQcd3xfbOb2,0,22,12,4,16,2,1,3,11,0.135396,0.140815,49.035857,2,0.000305
John C,John C,,210307,57,66lf5bQo2BIEue1pxfgxQS,0,22,6,2,8,11,2,13,9,0.18128,0.191343,978.929269,2,0.00051
Don Patricio,Don Patricio,,583731,59,6vPXtLmNd3mW0dd1Rb9eQ9,0,22,11,6,17,44,5,49,8,0.259231,0.28588,1838.793758,3,0.001071
Paco Amoroso,Paco Amoroso,,122852,53,3E7NGbzUGlOjgYY8nvtijR,0,22,4,3,7,12,3,15,8,0.2053,0.218467,740.404727,2,0.001854
Axel Fiks,Axel Fiks,,31152,50,6GEaxHZNiogI175zUr4KvH,0,22,5,4,9,6,3,9,8,0.224967,0.239217,1006.688987,5,0.000826
Seven Kayne,Seven Kayne,,1093254,63,4C29ETLBPmYKYwtJUepbJz,0,22,13,7,20,11,12,23,8,0.261748,0.290035,816.054731,2,0.001623
Homer El Mero Mero,Homer El Mero Mero,,212332,62,0Xo4VFS3v07L0GwIVkZLfg,0,22,25,14,39,21,15,36,8,0.26746,0.301727,7216.894175,2,0.001546
Polimá Westcoast,Polimá Westcoast,,252639,77,768O5GliF0bqscyghggrbE,0,22,21,13,34,29,30,59,7,0.284148,0.321905,2432.766907,2,0.002357
LIT killah,LIT killah,,3640317,74,1vqR17Iv8VFdzure1TAXEq,0,22,11,10,21,17,10,27,7,0.287175,0.324043,2140.743087,2,0.001659
ACRU,ACRU,,289532,50,0bYQe0JDIjxkSHQoXlfngl,0,22,5,4,9,2,1,3,9,0.193234,0.203329,114.360231,2,0.000294
Blunted Vato,Blunted Vato,,269922,55,15RLdM61VHtknTIYIuNviR,0,22,9,9,18,8,4,12,8,0.237074,0.259383,35.174422,0,0.000383
LOUTA,LOUTA,,152863,58,5l4GdLELvdnXZVT5g947i3,0,22,5,4,9,5,2,7,9,0.199645,0.212653,1195.209606,5,0.000985
Ecko,Ecko,,987766,63,2Jb9jVnCpWkXtoGznFJ6bF,0,22,16,17,33,27,69,96,7,0.284388,0.325788,1767.292526,0,0.001288
Bejo,Bejo,,221687,66,0adJG3bdFTHCkTY28NkY4u,0,22,18,3,21,16,3,19,9,0.205802,0.22199,2589.908443,2,0.001777
Estani,Estani,,13052,59,4QmDIEVrROsBAad02Mlc1p,0,22,5,4,9,6,4,10,8,0.215061,0.23008,533.800961,2,0.00073
Jay Kalyl,Jay Kalyl,,167125,53,0sHeKC0Zcxpz4wOHHE5oJ7,0,22,11,2,13,11,1,12,10,0.169049,0.177879,491.752334,4,0.001601
Alex Sensation,Alex Sensation,,165903,58,0OROVBEZCocg0FcgJpyBse,0,22,1,16,17,1,33,34,7,0.303194,0.344945,15.170161,0,0.000324
Amaia Montero,Amaia Montero,,1019704,56,4LbuSjHhhAddvN44qXpRJo,0,22,7,1,8,13,1,14,7,0.224817,0.237286,738.314866,3,0.00077
Greeicy,Greeicy,,5647395,69,5dbaLmK5SHLLg8Z4CcTJpX,0,22,17,7,24,84,82,166,6,0.294323,0.32453,1652.25153,1,0.001184
Mike Bahía,Mike Bahía,,2599436,66,1phfTBIocBW3UwqcYjaEN6,0,22,10,13,23,36,22,58,7,0.288157,0.325046,1234.053383,1,0.000861
Fito Paez,Fito Paez,,1282796,63,1bZNv4q3OxYq7mmnLha7Tu,0,22,22,4,26,16,15,31,7,0.238415,0.255186,2053.645591,5,0.001381
Fanny Lu,Fanny Lu,,841417,58,6GRC8segVAr34gm6pjfSoQ,0,22,5,13,18,7,18,25,7,0.301566,0.335524,3589.417332,1,0.000781
Rubén Blades,Rubén Blades,,1179200,62,5BwMgvRwlq61SmknvsVIQj,0,22,13,6,19,14,2,16,8,0.261849,0.280276,1162.379195,5,0.001844
Lucas Arnau,Lucas Arnau,,239638,51,5vLOlJcOKe9DfBC5LeLpSs,0,22,3,3,6,3,3,6,8,0.26874,0.290065,706.460869,5,0.000328
Yera,Yera,,56066,60,1vrahybrKylgwkjhbmOz94,0,22,10,11,21,84,36,120,7,0.303604,0.336488,791.802761,3,0.000703
Felipe Peláez,Felipe Peláez,,1087833,57,6dexNK5MjEL8UvmA5MjSgg,0,22,2,7,9,3,11,14,7,0.295226,0.324668,201.191273,5,0.000465
Silvestre Dangond,Silvestre Dangond,,3691918,64,3OcvS8PzSGYMBvLdzY6g3e,0,22,16,6,22,17,9,26,8,0.279668,0.311431,2823.794203,5,0.001278
Lali,Lali,,1340248,65,22P1OY4TRFRwhP0q29loQ8,0,22,11,6,17,13,10,23,7,0.271337,0.298414,1528.535416,3,0.001173
Rafa Pabön,Rafa Pabön,,208523,67,11YLRSsZA3YVuQQtHXKTlz,0,22,36,24,60,59,31,90,7,0.297703,0.34621,3170.64484,0,0.003051
Javiielo,Javiielo,,249517,62,3HH6yOn1yJNZo3RY5zEfy5,0,22,10,9,19,13,21,34,7,0.271884,0.306118,721.488223,0,0.001029
Anonimus,Anonimus,,263901,52,62lbdm09j0QUbWB7SqCJvt,0,22,30,60,90,33,142,175,7,0.327184,0.397248,3359.566123,0,0.003025
José Luis Perales,José Luis Perales,,1813945,63,5RwfJb8wxN1fuodcPORVxP,0,22,4,2,6,19,4,23,8,0.230664,0.246091,771.919035,5,0.000471
José Maria Napoleón,José Maria Napoleón,,857555,60,72v53CufRiSyqcQ78KUQ5p,0,22,5,3,8,94,6,100,7,0.243146,0.26342,589.281178,5,0.000687
María José,María José,,2008005,68,1dJyh390MvfYPuNbhnbSDs,0,22,18,15,33,32,103,135,7,0.277366,0.312173,3802.629937,5,0.001591
Antonio José,Antonio José,,480558,61,1dbp04JzZ81JXlMGupCnJ8,0,22,3,14,17,5,29,34,7,0.307482,0.34173,894.363914,3,0.000453
Mijares,Mijares,,1632492,66,3zhijRRIZX2B6G2T7vJl9p,0,22,5,5,10,6,7,13,7,0.241491,0.263487,1018.942144,5,0.000616
Karen Méndez,Karen Méndez,,529499,53,0txXDZCdXBzha20sgN1GRk,0,22,2,5,7,3,9,12,8,0.270574,0.29787,825.421005,1,0.000451
Jerry Di,Jerry Di,,246603,62,7f02bxFbZIOVdSbYRNYvLT,0,22,13,14,27,46,32,78,7,0.281655,0.322527,499.1532,0,0.000894
Sammy & Falsetto,Sammy & Falsetto,,309083,51,6AT27ojKlBuZToFIGwQZDc,0,22,6,13,19,7,17,24,7,0.283431,0.3247,50.794236,0,0.000383
Dayme y El High,Dayme y El High,,235122,52,4JreHVYyb6GqE2BU03Kx96,0,22,14,44,58,20,96,116,7,0.324976,0.3844,4777.677312,0,0.001327
Jd Pantoja,Jd Pantoja,,3278280,57,7yjRUA0Iz3VI4Kqa5oPJZK,0,22,4,9,13,8,11,19,8,0.282955,0.320372,449.033436,0,0.00053
Canserbero,Canserbero,,4758472,70,1wGIhYkKWSq4yACtTkCkSX,0,22,3,2,5,5,3,8,10,0.152076,0.157625,63.340245,3,0.001994
McKlopedia,McKlopedia,,219996,56,1PNgAcUW6UgN59okEaTpvG,0,22,9,5,14,16,3,19,9,0.179303,0.188533,1026.617576,1,0.002242
Jowell,Jowell,,133243,51,6TASDj2ogOKQptnxgEvrcP,0,22,15,50,65,17,235,252,7,0.326392,0.387293,1423.385406,0,0.001628
Ñejo & Dalmata,Ñejo & Dalmata,,1174051,62,1ykothWH0xl8drRyJWuw7I,0,22,14,10,24,199,24,223,7,0.273206,0.307355,28.203034,0,0.001657
J-King y Maximan,J-King y Maximan,,150615,52,6UBb8ZUUyarsyod6snflAR,0,22,18,25,43,20,35,55,7,0.298626,0.347001,1053.67869,0,0.001476
Carlitos Rossy,Carlitos Rossy,,254846,50,0FDJB5xf8i09jDjIg1qNED,0,22,7,29,36,5,70,75,7,0.300893,0.351233,677.591559,0,0.000623
TINI,TINI,,4656464,79,7vXDAI8JwjW531ouMGbfcp,0,22,9,17,26,30,89,119,7,0.313052,0.35172,1906.058323,3,0.001171
Sofía Reyes,Sofía Reyes,,2557027,72,0haZhu4fFKt0Ag94kZDiz2,0,22,7,11,18,8,73,81,7,0.301027,0.336689,515.229024,0,0.000601
Mon Laferte,Mon Laferte,,4636707,71,4boI7bJtmB1L3b1cuL75Zr,0,22,13,7,20,50,22,72,7,0.272103,0.297047,4728.322273,5,0.002741
Bunbury,Bunbury,,2068892,67,4uqzzJg3ww5eH7IgGV7DMT,0,22,11,5,16,15,15,30,8,0.233299,0.251009,1313.982715,5,0.001572
Gloria Trevi,Gloria Trevi,,3707488,70,1Db5GsIoVWYktPoD2nnPZZ,0,22,12,8,20,16,37,53,7,0.286687,0.314876,2924.587174,3,0.001266
Caloncho,Caloncho,,641352,63,2z3KntXLyEF5Lvz1kpdBoA,0,22,9,3,12,86,17,103,7,0.218618,0.233104,1710.246652,5,0.001858
Chino & Nacho,Chino & Nacho,,2353950,63,5NS0854TqZQVoRmJKSWtFZ,0,22,4,11,15,119,73,192,7,0.288898,0.325364,125.021712,1,0.000372
Daniel Santacruz,Daniel Santacruz,,121431,53,4tLUnrSgMM7tT0zVs3wX61,0,22,6,2,8,6,3,9,8,0.215956,0.229059,1096.912926,4,0.000565
Joey Montana,Joey Montana,,2588738,64,3ATyg4fGC9F8trfb0GRWmX,0,22,14,20,34,43,99,142,7,0.312326,0.354688,4322.218592,3,0.001083
Luis Enrique,Luis Enrique,,834630,59,2mUI4K6csTQd3jieswcmiI,0,22,11,1,12,8,2,10,7,0.230506,0.244729,266.568651,1,0.000676
Lyan,Lyan,,44907,54,2GzKA5uPf3Nef6JjkUNk4H,0,22,12,37,49,13,147,160,7,0.311748,0.369517,458.9155,0,0.000926
Malú,Malú,,1520215,61,3TLGNOdp1UWYMnV5XG9HkR,0,22,13,50,63,27,201,228,7,0.336327,0.400459,8040.287273,5,0.001641
Antonio Orozco,Antonio Orozco,,1252650,62,1ADdpen72RPuafRcv0YRBf,0,22,5,10,15,10,25,35,7,0.292789,0.325954,701.730719,5,0.000474
Abel Pintos,Abel Pintos,,3158443,66,6HTUcOExehqydqa7C3usAa,0,22,21,11,32,26,12,38,7,0.285351,0.315794,3826.758232,5,0.001987
Jorge Drexler,Jorge Drexler,,698808,64,4ssUf5gLb1GBLxi1BhPrVt,0,22,19,6,25,32,8,40,7,0.270249,0.291112,5395.045649,5,0.002461
Toby Love,Toby Love,,577473,51,72R3RMGmSmzG57R7OUaDaN,0,22,7,12,19,11,14,25,7,0.281068,0.310478,235.570288,1,0.000674
Flex,Flex,,233515,61,13VwGEitoK8J0qjNjbgeTN,0,22,5,7,12,6,3,9,8,0.251399,0.2789,844.650314,1,0.000502
Nova y Jory,Nova y Jory,,780375,54,6ZK8loFAzWKSFe3b7Lrq4V,0,22,2,15,17,2,22,24,7,0.284749,0.324565,24.571651,0,0.000455
Lirico En La Casa,Lirico En La Casa,,191417,58,1Vr7DTbtTpOp4tn4hAGOYo,0,22,8,11,19,14,11,25,8,0.275665,0.308823,769.565275,0,0.001145
Rusherking,Rusherking,,910150,71,3Apb2lGmGJaBmr0TTBJvIZ,0,22,17,8,25,20,12,32,8,0.26124,0.28954,2898.122852,2,0.00252
FMK,FMK,,889012,70,0dUyjgCyjfj5eMx6bX2TWf,0,22,11,19,30,10,43,53,7,0.292281,0.330521,4244.809556,2,0.001235
Midel,Midel,,323906,52,4EcIU574ksr6mC1GMEOe0p,0,22,6,8,14,8,8,16,8,0.258337,0.285534,34.420082,2,0.000519
Leonel García,Leonel García,,654469,63,3t7UqWteBBmHXkcVhMSyay,0,22,17,18,35,22,31,53,7,0.316135,0.35444,6307.847688,5,0.001323
Santiago Cruz,Santiago Cruz,,872699,57,5ClJtuiNlr83ua45Dvpcf7,0,22,3,16,19,4,19,23,7,0.301296,0.334559,1435.304842,5,0.000555
Soledad,Soledad,,412115,58,0K59Fm1y7s3j498ueS4qzY,0,22,14,16,30,28,19,47,7,0.29381,0.32399,5348.798028,5,0.001041
Reyli Barba,Reyli Barba,,1496382,63,69BUYvpG9MbjCyIZfsFdhJ,0,22,10,14,24,10,16,26,7,0.288775,0.324544,10112.475231,5,0.000897
Kumbia Kings,Kumbia Kings,,278595,53,3jO5UGHrEzfd5YIamfs7Ir,0,22,1,5,6,2,13,15,6,0.269384,0.292359,1360.810854,5,0.000245
Erik Rubin,Erik Rubin,,267253,53,43hb5av90CTCWFldaaTp7n,0,22,9,5,14,19,6,25,8,0.230822,0.249744,790.258697,5,0.000976
Joaquín Sabina,Joaquín Sabina,,2518798,66,4aeIWo5CMF1uRmqgJdwkZW,0,22,12,9,21,22,9,31,7,0.267142,0.295072,2605.82578,5,0.001684
Andrés Calamaro,Andrés Calamaro,,1988292,68,3tAICgiSR5PfYY4B8qsoAU,0,22,18,14,32,51,24,75,7,0.29929,0.333199,7694.474526,5,0.001516
Edith Márquez,Edith Márquez,,1060794,60,7afXSXOa8dE3c2C5XIguAv,0,22,3,2,5,5,3,8,7,0.248617,0.265469,136.989327,3,0.000414
KURT,KURT,,239582,62,4kcnsS1aAB40FMcLD01gmI,0,22,4,6,10,5,10,15,7,0.282126,0.305504,1361.921089,5,0.00056
Esteman,Esteman,,255741,60,3ZtIhDSOuRkpDyqjx53X1R,0,22,4,9,13,3,50,53,7,0.253956,0.279702,595.899655,5,0.000462
DELLAFUENTE,DELLAFUENTE,,570579,64,4bJh7sMPcVRiqe5jlnsWQV,0,22,4,8,12,6,10,16,8,0.27657,0.308766,1002.980714,2,0.000555
Kaydy Cain,Kaydy Cain,,359027,62,4nXXIxTneJksvGXrlmX8oA,0,22,20,18,38,21,30,51,8,0.263796,0.301401,2872.01466,2,0.001692
Cruz Cafuné,Cruz Cafuné,,208391,68,0jeYkqwckGJoHQhhXwgzk3,0,22,20,12,32,18,4,22,9,0.233057,0.253212,2362.849704,2,0.002508
Monica Naranjo,Monica Naranjo,,614373,59,0zGM73sadbAOBLev02P8LO,0,22,4,3,7,4,4,8,8,0.225493,0.244177,137.967774,5,0.000572
Alkilados,Alkilados,,1915949,56,2DP9xStkVVv753RBiEHXQB,0,22,4,17,21,5,33,38,7,0.305669,0.345369,2208.799234,0,0.000545
Pepe Aguilar,Pepe Aguilar,,3656092,69,03Yb3iBy9GCifXiATEFcit,0,22,8,3,11,9,3,12,7,0.249907,0.270796,831.692003,5,0.001778
Intocable,Intocable,,2770565,71,108moq3rq6bm1M4Ypz0J02,0,22,5,1,6,6,1,7,8,0.214786,0.227729,686.712285,5,0.001695
Yuridia,Yuridia,,2828293,70,5B8ApeENp4bE4EE3LI8jK2,0,22,8,2,10,95,2,97,7,0.260836,0.283736,234.450024,5,0.00088
Rocío Dúrcal,Rocío Dúrcal,,3179921,68,2uyweLa0mvPZH6eRzDddeB,0,22,2,8,10,2,25,27,7,0.264417,0.292366,896.93353,5,0.000294
Armando Manzanero,Armando Manzanero,,610737,56,5lODCkFdEtpPn3YxfmyLfT,0,22,4,7,11,6,13,19,7,0.287911,0.316137,1333.664792,5,0.000424
Mercedes Sosa,Mercedes Sosa,,760831,57,2HvyR5FsU37QMqVzIbGwl7,0,22,7,25,32,8,46,54,7,0.290768,0.327215,3888.955657,5,0.001351
Pandora,Pandora,,267973,58,44nb9BaqV2jVvxKCaXHwlP,0,22,5,8,13,6,9,15,7,0.277595,0.304493,990.007097,5,0.000529
Ventino,Ventino,,1298285,52,1G89WXRVVAEjU4VIwgg6XD,0,22,2,5,7,2,5,7,7,0.260433,0.28411,202.254522,3,0.000557
Manuel Medrano,Manuel Medrano,,2118539,65,0i5iO6icb7kxg48thi9gBM,0,22,4,1,5,5,1,6,8,0.228785,0.242631,19.848826,5,0.000565
WOS,WOS,,2829792,71,5YCc6xS5Gpj3EkaYGdjyNK,0,22,5,5,10,3,6,9,8,0.239262,0.259068,1686.11707,2,0.000968
Camila,Camila,,3598466,69,2gRP1Ezbtj3qrERnd0XasU,0,22,5,7,12,17,13,30,7,0.289519,0.319698,567.722354,5,0.000663
Yannc,Yannc,,47175,52,3rqKgkODmiyDdimpz5D3y1,0,22,3,11,14,4,12,16,7,0.278053,0.315935,59.314771,0,0.000564
Jamby El Favo,Jamby El Favo,,797441,64,128ftF9X7Kd7Di2fq3wYVs,0,22,20,17,37,39,34,73,7,0.293426,0.332362,3330.270066,0,0.002206
Flow La Movie,Flow La Movie,,13816,60,2oT7xd9iTO2ejLsNGIMa5f,0,22,3,3,6,12,4,16,8,0.249168,0.275276,0,0,0.000398
Leiva,Leiva,,609201,63,5Hsv8dUHHOdnn72q4XIVz7,0,22,14,12,26,14,10,24,7,0.240628,0.262526,1677.35405,5,0.001566
Los Auténticos Decadentes,Los Auténticos Decadentes,,1708603,67,3HrbmsYpKjWH1lzhad7alj,0,22,18,21,39,14,22,36,7,0.27623,0.30668,7317.457023,5,0.001062
León Larregui,León Larregui,,1710236,65,4ClsVDy2g7RKSSlvq8cF6d,0,22,3,1,4,4,7,11,8,0.214036,0.225595,31.614363,5,0.000781
Panteon Rococo,Panteon Rococo,,2211649,65,11mqrDSFRRz8g0Wb3syJj5,0,22,4,6,10,5,4,9,8,0.22894,0.246566,236.796736,5,0.000562
Ely Guerra,Ely Guerra,,362793,51,1ne2c2YEgt4MmJCJGCsfsZ,0,22,6,4,10,3,3,6,7,0.256664,0.27612,1426.720754,5,0.000835
Kevin Johansen,Kevin Johansen,,329347,55,7qjoG7bwhAjSd7nJTcjgAk,0,22,10,6,16,4,13,17,7,0.236574,0.255564,197.194671,5,0.000677
Oscar D'León,Oscar D'León,,1188713,57,1c84wItoiAe1pEbpJMqUmQ,0,22,9,8,17,10,14,24,7,0.246255,0.270111,2748.261747,5,0.001494
Eddie Dee,Eddie Dee,,437695,56,7zLcnirfgw1VEHHshuGcDR,0,22,6,11,17,7,16,23,8,0.260232,0.293164,249.026188,1,0.000728
Jesús Adrián Romero,Jesús Adrián Romero,,3356388,70,29SeiO68HQHBs7pDdWOvvX,0,22,6,8,14,10,11,21,7,0.248984,0.272926,5291.955434,4,0.00157
Marcela Gandara,Marcela Gandara,,1438828,62,2zF0KCQEt1O4Z9fWVUVi4T,0,22,11,4,15,13,4,17,8,0.204428,0.220049,1973.798398,4,0.002022
Lilly Goodman,Lilly Goodman,,1332835,60,6vetaGijEBK3wfhtCUWRBS,0,22,8,4,12,8,9,17,8,0.228707,0.247933,2002.364781,4,0.001341
Alex Campos,Alex Campos,,1427454,61,6slyJwua5e5GuhuP82sTHR,0,22,17,16,33,24,32,56,7,0.26874,0.301046,13655.355491,4,0.00268
Abel Zavala,Abel Zavala,,469172,52,0UH4eoqwQgADwRoaKtEKc1,0,22,1,1,2,2,1,3,9,0.169816,0.178463,0,4,0.000413
Ovy On The Drums,Ovy On The Drums,,159537,68,3m5qlPf2OkihLz3dRYnkPA,0,22,6,7,13,6,8,14,8,0.266614,0.295551,986.230852,3,0.000748
Enrique Guzman,Enrique Guzman,,467846,53,4FeDV8T2wgjzYKBamSp7MG,0,22,1,6,7,2,8,10,7,0.264729,0.287767,56.360106,5,0.000253
María León,María León,,55751,56,132xFnGXTZoDfZWuMDE4tc,0,22,7,6,13,7,10,17,7,0.262461,0.287834,394.742607,5,0.000598
Miranda!,Miranda!,,835413,65,2eEmsgWmUFMbtU7agJpnjY,0,22,10,18,28,16,18,34,6,0.294323,0.328709,3547.37007,5,0.001103
Kinky,Kinky,,464659,55,4WOIfFwyvx22jM0eg2fpKv,0,22,8,2,10,6,3,9,8,0.225418,0.238556,373.187542,3,0.001001
Tercer Cielo,Tercer Cielo,,1402687,60,2bimgkRmsxRhhuWsOnd5rz,0,22,6,6,12,4,9,13,9,0.206053,0.224448,1491.69526,4,0.000534
LA INDIA,LA INDIA,,761314,57,3NIZFmehJM8YiGpCdihlck,0,22,10,9,19,10,14,24,7,0.263076,0.287145,3828.885849,5,0.001587
Tito Nieves,Tito Nieves,,1103918,60,4vOycwLXdkMMzpZW04VW5m,0,22,8,7,15,8,8,16,8,0.257547,0.286929,1187.999344,5,0.00117
Musicologo Y Menes,Musicologo Y Menes,,162843,51,0xf0KaVp6AMWgesiBh6fee,0,22,7,31,38,7,78,85,7,0.299157,0.350057,684.990965,0,0.000779
Marcela Morelo,Marcela Morelo,,62462,51,63xFjf6Ww22O5gHrBP79G9,0,22,10,7,17,3,7,10,8,0.256762,0.28088,301.03419,5,0.000497
León Gieco,León Gieco,,234591,52,5yoimVE1rbc3kAx4uwr7eq,0,22,20,3,23,19,3,22,8,0.225418,0.241054,637.163283,5,0.001142
Delaossa,Delaossa,,164713,59,5Uox3n7m4W2CoM9MmHPJwQ,0,22,15,9,24,17,8,25,9,0.211352,0.226094,1569.226131,2,0.001371
Moderatto,Moderatto,,752644,63,5XsWrYhwadPBjW20qYbdZg,0,22,2,6,8,15,8,23,7,0.282718,0.307719,1198.730257,3,0.000542
Alex Gargolas,Alex Gargolas,,53856,59,7awyvLSthqOcL5A3hnR1pf,0,22,1,41,42,2,116,118,7,0.331204,0.386142,71.947893,0,0.0003
Nino Freestyle,Nino Freestyle,,114525,50,1AACxWCwNIa3ecOBQJnXRV,0,22,11,8,19,11,7,18,8,0.253383,0.281556,277.52488,0,0.001444
Ana Torroja,Ana Torroja,,590648,59,5YekZn3GGnPIURNA6RG124,0,22,11,11,22,19,45,64,6,0.293426,0.325618,4857.0511,5,0.001114
Selena,Selena,,2846836,69,6IE6z7DcZIT4Ml3Fh5Ivch,0,22,1,4,5,1,7,8,7,0.265354,0.291031,724.586293,0,0.000274
Alvaro Torres,Alvaro Torres,,245496,53,7p5DVejD1eXP8GO6clYQlE,0,22,1,2,3,1,2,3,9,0.181427,0.190484,8.323676,5,0.000281
Bad Gyal,Bad Gyal,,750208,68,4F4pp8NUW08JuXwnoxglpN,0,22,7,4,11,219,32,251,8,0.263281,0.290529,1258.490725,3,0.001118
South Park Mexican,South Park Mexican,,751865,61,4kKaAWGdu6WW0W415RWaQA,0,22,8,5,13,6,2,8,9,0.209122,0.221692,208.147462,2,0.000709
Orishas,Orishas,,421030,55,2gKYxTUOqw9aPt7ljMwSHT,0,22,5,7,12,6,7,13,6,0.277024,0.302448,599.754852,1,0.00083
Omar Montes,Omar Montes,,429816,69,3lY9Fxceu60W1rbon7PkuF,0,22,17,16,33,55,152,207,7,0.303058,0.343885,9964.126126,3,0.001628
Pitizion,Pitizion,,100869,53,0GWdY55YF6xzN5L1A0X8nq,0,22,5,4,9,6,49,55,7,0.264314,0.288773,1066.260032,1,0.000662
Eddy Lover,Eddy Lover,,387524,59,7gR53ad9JjCweCv4f9MWEX,0,22,2,6,8,84,15,99,8,0.246796,0.26912,361.125937,6,0.000393
Cristian Castro,Cristian Castro,,2533521,68,2AZOALDIBORfbzKTuliwdJ,0,22,8,7,15,7,7,14,6,0.294066,0.322206,1326.067387,5,0.000694
Benny,Benny,,253654,58,3YHFRVdfHlJ98iAc50PIYk,0,22,12,24,36,14,44,58,6,0.319129,0.363872,5810.039596,0,0.001302
Elvis Crespo,Elvis Crespo,,823766,64,1c22GXH30ijlOfXhfLz9Df,0,22,9,22,31,8,29,37,7,0.299422,0.342882,3218.770026,5,0.001379
Pedro Guerra,Pedro Guerra,,168404,53,2GrNjfw23jqL1NTopPlc6c,0,22,3,14,17,3,27,30,7,0.295614,0.325894,748.150295,5,0.000445
Monsieur Periné,Monsieur Periné,,515291,60,36KsCCwgI0Dep97yVJWmkK,0,22,7,5,12,6,7,13,7,0.259931,0.28015,713.577524,5,0.000547
Dulce María,Dulce María,,666527,68,6kaefrHSdAvxhhCVDFTCEL,0,22,4,3,7,25,4,29,8,0.252718,0.275397,1026.193311,5,0.000576
Nahuel Pennisi,Nahuel Pennisi,,78282,58,4IjHltwoSKbUeZLPeULyDe,0,22,11,9,20,4,4,8,8,0.226555,0.242055,214.623461,5,0.000646
Alex Ubago,Alex Ubago,,1873181,64,2tY2GFdhH0Wa2VBvsxew5X,0,22,4,12,16,5,21,26,6,0.289892,0.319337,3737.689551,3,0.001061
Bulin 47,Bulin 47,,271179,52,4J0m1OquRGY8HYHxMocXfy,0,22,9,14,23,30,45,75,8,0.268099,0.306465,191.224389,0,0.001222
Bulova,Bulova,,131083,50,6NAhbfEqeWELwfjH391Vz0,0,22,11,17,28,19,32,51,7,0.290893,0.331288,499.670686,0,0.001232
Yung Sarria,Yung Sarria,,78767,56,3vxYNXtM9uOMdRAXTXgtmf,0,22,15,4,19,8,17,25,8,0.222076,0.240156,126.954571,2,0.000584
Foreign Teck,Foreign Teck,,7319,52,12lHTAdc9T204lw5qPtasv,0,22,1,6,7,1,7,8,7,0.274095,0.305486,0.315909,0,0.00029
Bhavi,Bhavi,,936608,66,7fT2Me47PQ8T7954PKrcwR,0,22,14,16,30,12,30,42,8,0.273428,0.314038,2088.068316,2,0.001846
Diego Torres,Diego Torres,,1717040,63,0LALueHEQunQ2d61fXGeZh,0,22,4,32,36,8,46,54,6,0.342306,0.392235,2857.987978,5,0.00047
Alexander Acha,Alexander Acha,,516045,56,3JkgQ8Jjwt2mkeOsg5yhqh,0,22,2,3,5,3,4,7,8,0.225569,0.240731,22.042285,5,0.000277
Bandalos Chinos,Bandalos Chinos,,207271,58,0wn2qDKzeFlhjRUtJAwJjp,0,22,6,2,8,8,2,10,10,0.166667,0.174451,390.948773,5,0.000687
Lele Pons,Lele Pons,,1097821,61,6i3DxIlAqnDkwELLw4aVrx,0,22,5,4,9,24,122,146,7,0.273206,0.301222,35.578613,3,0.000421
Alejandro Lerner,Alejandro Lerner,,293846,58,6ESkuwldylZr39AIAPC63J,0,22,10,8,18,5,7,12,7,0.275439,0.300314,654.264796,5,0.00049
Miguel Ríos,Miguel Ríos,,209849,56,1dpnxi6xgoB2kaRYnnoatZ,0,22,3,8,11,3,8,11,7,0.255787,0.278063,2594.281232,5,0.000326
Mikel Erentxun,Mikel Erentxun,,121815,56,7thnnayFyJnVOAJrpe5wMC,0,22,1,4,5,1,7,8,8,0.235335,0.253764,38.14051,5,0.000279
Leo Dan,Leo Dan,,2089641,66,6qhOH2mrlqUDod9sWA5kR2,0,22,3,15,18,2,16,18,7,0.300893,0.337254,1035.049621,3,0.000564
Amanda Miguel,Amanda Miguel,,1309564,60,3v8mFhjLFa50QK8zDvAMYN,0,22,2,4,6,48,10,58,7,0.246075,0.264759,39.143474,5,0.000464
Diego Verdaguer,Diego Verdaguer,,1021905,63,2UFqwY8A3PLcx8pAkg9g5P,0,22,5,3,8,8,48,56,8,0.232414,0.248292,1427.471175,5,0.000494
Los Caligaris,Los Caligaris,,876274,62,13wFTN72PGSUxzEHJP5Ljs,0,22,12,10,22,6,8,14,8,0.236325,0.253368,201.683984,5,0.000453
Daniela Romo,Daniela Romo,,834490,58,6gvh8pQI316iafbHiT7B3y,0,22,2,7,9,2,7,9,7,0.279552,0.305755,247.848512,5,0.000359
Alizzz,Alizzz,,51264,56,23herDudxPBB3S81GB5uG3,0,22,3,2,5,10,3,13,8,0.24297,0.259695,586.566015,3,0.00061
Sticky M.A.,Sticky M.A.,,104770,55,5o7fmoqHl79fzoCzeApdxm,0,22,7,10,17,4,17,21,8,0.266825,0.29551,2783.248844,2,0.000744
Vetusta Morla,Vetusta Morla,,656389,59,6J6yx1t3nwIDyPXk5xa7O8,0,22,1,3,4,1,3,4,8,0.226023,0.242658,65.770783,5,0.000557
Jesse Baez,Jesse Baez,,115201,56,4rriNpL1lxpoysDDctWgl3,0,22,9,4,13,11,26,37,7,0.261951,0.28269,1864.138145,2,0.001664
Lasso,Lasso,,335629,71,3SCOuAxngTC1yGjKMcIPEd,0,22,5,4,9,6,19,25,7,0.267673,0.288035,466.789455,5,0.000414
C-Kan,C-Kan,,2020134,68,1QhaqxeqF9sipS2gwbEKpu,0,22,7,10,17,10,7,17,8,0.240628,0.262677,3533.099928,2,0.001266
Dharius,Dharius,,1537409,64,66RfYVdftqnuHRicyClgL0,0,22,2,1,3,1,4,5,9,0.194013,0.204911,0,2,0.000438
MC Magic,MC Magic,,283101,52,3cuVSUrq0yoSSP7gpvI6q1,0,22,11,8,19,4,6,10,9,0.213494,0.228959,56.343245,2,0.000626
Santa RM,Santa RM,,529253,58,30BSBWLKnYJION1lCPugXc,0,22,3,4,7,2,6,8,9,0.207193,0.220979,677.211536,2,0.000438
Fyahbwoy,Fyahbwoy,,105626,51,6uFTGm4t8Z6tXyCm22sLQM,0,22,13,7,20,12,5,17,8,0.204057,0.216368,1805.997905,2,0.001828
Motel,Motel,,193635,55,19IsMFpELM7g2UDuwDlZvU,0,22,1,3,4,1,3,4,7,0.2488,0.267695,44.766318,5,0.000319
Lila Downs,Lila Downs,,374049,58,3mXI2gpwWnNO9qbQG3n3EP,0,22,14,10,24,17,26,43,7,0.263796,0.291967,2538.802559,5,0.001052
Ana Tijoux,Ana Tijoux,,382578,56,40JMTpVRUw90SrN4pFA6Mz,0,22,5,4,9,13,5,18,8,0.234353,0.250058,409.742714,5,0.001901
El Roockie,El Roockie,,157099,50,3sc8HnadkPW5YaIGbCljw4,0,22,5,10,15,8,23,31,8,0.269277,0.303149,650.681788,0,0.000463
Charlie Zaa,Charlie Zaa,,147728,54,1KfBKoozFugeT1PBkz33xl,0,22,2,6,8,1,6,7,7,0.273206,0.300057,260.80858,5,0.000255
Carolina Ross,Carolina Ross,,371316,57,5wx70QuZtxRUIIYek3RSaV,0,22,1,1,2,1,2,3,8,0.244824,0.263514,5.031153,0,0.000255
Soge Culebra,Soge Culebra,,209013,53,2SNfNJDsahTSVFwgxposF5,0,22,7,5,12,2,4,6,7,0.264937,0.284492,3377.253582,3,0.00049
Luciano Pereyra,Luciano Pereyra,,1818592,62,6ZZ2DeepA3GpoGU4KwqSlU,0,22,7,8,15,7,25,32,6,0.286443,0.313773,980.684211,1,0.00063
No Te Va Gustar,No Te Va Gustar,,1827278,66,4ZDoy7AWNgQVmX7T0u0B1j,0,22,3,7,10,3,6,9,7,0.245269,0.262654,204.028364,5,0.000329
Charly García,Charly García,,1274868,62,3jO7X5KupvwmWTHGtHgcgo,0,22,13,1,14,10,19,29,9,0.199173,0.209501,163.292412,5,0.000972
Mocedades,Mocedades,,561778,55,4Sm7JCttzWMwHJtb3UJ8SY,0,22,1,11,12,1,23,24,7,0.288034,0.317585,514.853323,5,0.000422
Redimi2,Redimi2,,1813034,62,0WZOmdnCln6FK6GM9e2tGm,0,22,16,17,33,50,26,76,8,0.246075,0.279188,10116.142996,4,0.002627
Christine D'Clario,Christine D'Clario,,1060204,61,6JaSyvyg28SHC0Of8YE6M9,0,22,11,5,16,25,4,29,10,0.158068,0.168273,170.174479,4,0.001591
Evan Craft,Evan Craft,,526244,58,4vEpUOtKWtpotWkuv0Vlx4,0,22,13,12,25,19,33,52,8,0.220189,0.245741,3093.916709,4,0.003138
Barak,Barak,,680477,58,2IzxJqK9NbSIdw7rQVW03P,0,22,3,8,11,6,19,25,8,0.219544,0.241043,125.889421,4,0.000747
Julio Melgar,Julio Melgar,,831786,59,5O46r5EwzdUL8RR1aM6yU2,0,22,6,3,9,8,3,11,9,0.176301,0.18784,151.566095,4,0.001564
Alex Zurdo,Alex Zurdo,,1265959,62,0WI8OfWCRvK4nGHmKfFQmd,0,22,15,16,31,20,55,75,8,0.245269,0.277644,7070.325585,4,0.002234
Miel San Marcos,Miel San Marcos,,1259895,62,7zpvy5B9gb5KprNUzNCOEE,0,22,10,13,23,17,18,35,9,0.205363,0.230065,1963.789136,4,0.003015
Funky,Funky,,606009,61,4B4YYJ0BAYBK86yxqQV7mu,0,22,8,7,15,28,14,42,8,0.249076,0.27464,3542.802029,4,0.001822
Marcos Brunet,Marcos Brunet,,513738,54,7cLoxFihGCVL3s1K3xHK4I,0,22,12,3,15,26,36,62,10,0.170503,0.183105,1373.796538,4,0.003759
Annette Moreno,Annette Moreno,,263292,50,3ECxfxbxwRMTXdy1I5HWJq,0,22,3,5,8,7,6,13,9,0.208282,0.226841,1536.537678,4,0.00072
Danny Berrios,Danny Berrios,,386048,50,3e6e7N2fMD8rtk2PBVyMkm,0,22,2,2,4,1,1,2,8,0.21195,0.226046,0,4,0.000382
Coti,Coti,,250928,63,1OUDQLymoysITxprkd0Qvj,0,22,7,10,17,6,34,40,7,0.266719,0.293595,1590.268933,5,0.000714
Dyango,Dyango,,768073,55,0PbO1lSBsJPgyqdEypJJVb,0,22,2,2,4,4,3,7,8,0.19929,0.211693,420.164332,5,0.000571
DEKKO,DEKKO,,360379,68,6ZvYYrrfpb1Z7kICDyxWQE,0,22,2,3,5,2,3,5,8,0.245627,0.268362,26.005248,3,0.000427
Jorge Villamizar,Jorge Villamizar,,93848,53,3zPWcnruZBNnrd22uS8UBy,0,22,2,4,6,4,4,8,7,0.248525,0.26892,98.159144,5,0.000337
Angela Torres,Angela Torres,,128075,53,6LZA6PhNCwUfHzqfpN1nYL,0,22,6,2,8,5,2,7,8,0.225042,0.244148,945.045645,0,0.000966
Juan Ingaramo,Juan Ingaramo,,61886,52,2XVoz4hoXgQ3C2BTGxl9V2,0,22,8,11,19,2,9,11,7,0.266193,0.291236,1289.300919,5,0.000517
Los Amigos Invisibles,Los Amigos Invisibles,,372501,60,5x3mrCTZmkoTXURN7pWdGN,0,22,4,5,9,3,5,8,7,0.25482,0.277805,335.067203,5,0.000409
Gepe,Gepe,,319710,55,1fHGzTSloWCtrlKfbLNVhM,0,22,2,3,5,3,4,7,8,0.219902,0.236045,11.560554,5,0.000382
Los Pericos,Los Pericos,,1124758,62,7FnZWGw9lwOr7WzieTKEPR,0,22,3,8,11,2,8,10,7,0.284869,0.308881,1911.202664,5,0.000329
Los Nocheros,Los Nocheros,,492488,54,2ydE5oBt6cwsDxH1TpIFmO,0,22,8,5,13,10,4,14,7,0.243673,0.262431,588.930338,5,0.000441
Sael,Sael,,27338,58,6Itjwvv5YmsC8ZcI5N4Jux,0,22,5,14,19,4,15,19,7,0.288651,0.330239,1415.892491,0,0.000756
Corina Smith,Corina Smith,,141952,53,7mXfsy3lF4kU0f2KTNKSr8,0,22,4,12,16,2,15,17,7,0.289146,0.329324,64.76252,0,0.00035
Lapiz Conciente,Lapiz Conciente,,250601,50,0UTsdD7VIsEB9i7a6DDx5t,0,22,8,11,19,17,11,28,7,0.28095,0.31394,1295.793391,0,0.001226
Grupo Extra,Grupo Extra,,150043,57,4L5SLCIDWPPNGzrLraYCOS,0,22,4,4,8,6,3,9,8,0.247158,0.266428,395.029326,3,0.000525
Danny Romero,Danny Romero,,387472,55,30HlKUFTsqlFQsPfyv2yuM,0,22,3,11,14,6,19,25,7,0.288651,0.326593,468.519309,3,0.000332
Carlos Baute,Carlos Baute,,1681357,63,3smfreCkyJt7bShaTYpG77,0,22,2,12,14,3,27,30,7,0.304702,0.338431,373.817604,3,0.000355
Baby Bash,Baby Bash,,788905,61,12PSlydMSjEHzSCj9X5qv7,0,22,15,15,30,7,13,20,8,0.264314,0.291686,4526.317733,2,0.001554
Lérica,Lérica,,68059,61,4d3kmfoZBTuUPSUjgP45uo,0,22,3,13,16,4,142,146,7,0.302378,0.336636,408.732107,3,0.000302
Playa Limbo,Playa Limbo,,1593860,58,6XmHtVhgpE33VHFEp2V1P8,0,22,3,1,4,2,1,3,8,0.220333,0.234499,26.816687,5,0.000325
Pimpinela,Pimpinela,,1594385,60,7E7CVSqFdLyh0K4AE9uTMo,0,22,2,3,5,2,5,7,7,0.241577,0.260456,633.266721,5,0.00059
Fito y Fitipaldis,Fito y Fitipaldis,,1581242,65,1tZ99AnqyjgrmPwLfGU5eo,0,22,2,1,3,1,33,34,8,0.230585,0.244855,28.22821,5,0.000263
Elefante,Elefante,,1543658,66,5oYHL2SijkMY52gKIhYJNb,0,22,4,5,9,3,3,6,8,0.240114,0.256738,264.392975,1,0.000367
Edgar Oceransky,Edgar Oceransky,,154291,54,6genEcweKnEZ92TZvdeLFl,0,22,3,7,10,11,7,18,7,0.270249,0.29344,1013.551967,5,0.00041
La Unión,La Unión,,450107,56,2Ax9wZpdlg4r2zkc3pcI8U,0,22,2,1,3,3,1,4,9,0.185522,0.194176,2156.452138,5,0.000337
Fer Palacio,Fer Palacio,,1487418,62,4frBEXn8nhWzOVwfCSpuYB,0,22,3,4,7,2,2,4,9,0.218618,0.236334,242.550439,2,0.000297
Bacilos,Bacilos,,1484989,65,1mux8L6xg2Cmrc7k0wQczl,0,22,1,2,3,1,4,5,7,0.272654,0.290939,360.363192,3,0.000382
Wolfine,Wolfine,,1455381,58,2OnKRchqP7tT0FzTvWIFI7,0,22,1,3,4,2,8,10,8,0.262973,0.292163,2.395456,0,0.000304
Marcos Witt,Marcos Witt,,1380839,61,4x7kxyIgzgtrHYDQ8SCzo2,0,22,12,7,19,17,7,24,9,0.188268,0.206491,1362.946549,4,0.002187
Eddy Herrera,Eddy Herrera,,419025,56,4yNdrUaF54csrLixVTnqzC,0,22,4,4,8,1,5,6,8,0.236657,0.256668,49.786745,4,0.000257
Seth Condrey,Seth Condrey,,66884,50,4DeiqSO9kyWDr1KuQTYMVg,0,22,3,2,5,6,2,8,9,0.198061,0.214842,275.047494,4,0.001193
Su Presencia,Su Presencia,,212410,55,2gaFnEQydJdWNkT17NLZm3,0,22,4,2,6,9,6,15,8,0.21235,0.227777,0,4,0.000671
Essential Worship,Essential Worship,,19484,50,5ovBCDCRU118CMxJ1KpAOw,0,22,3,3,6,6,9,15,9,0.18031,0.193834,90.808692,4,0.000619
Christian Daniel,Christian Daniel,,75648,51,2fC8dVxeS2bsfIDvFj1M4V,0,22,3,5,8,4,6,10,8,0.275552,0.302665,459.634707,1,0.000594
Anahí,Anahí,,662214,68,0TeVa4xdLB8vdzjsvKH6Ri,0,22,1,2,3,1,9,10,7,0.270249,0.292995,32.901713,1,0.000299
El Tri,El Tri,,1390002,61,3HgZDevp7GspkLUAa5cKne,0,22,2,9,11,1,9,10,7,0.283074,0.313579,251.261693,1,0.000262
La Sonora Matancera,La Sonora Matancera,,190286,55,01p7Homi0d4XxZ06f2NYYD,0,22,3,2,5,29,42,71,9,0.177555,0.186046,107.56032,5,0.001402
Un Corazón,Un Corazón,,378811,58,4UGA0TDpRVVt2SCz8FZOMm,0,22,6,8,14,6,33,39,9,0.198586,0.219906,1698.158339,4,0.001522
Danilo Montero,Danilo Montero,,827856,56,2a48vLoCcVkOMcCSqXreOF,0,22,10,8,18,13,19,32,8,0.213561,0.233612,3024.467298,4,0.002442
Marco Barrientos,Marco Barrientos,,1258206,60,4VYSLPSI9yb8qkUpKyVQSJ,0,22,7,9,16,11,20,31,9,0.187639,0.206529,693.100762,4,0.001935
Johnny Prez,Johnny Prez,,147677,50,6gm3ZEpugRTHbtEn3A6Siw,0,22,4,8,12,4,10,14,8,0.2554,0.286265,7.928081,1,0.000337
ChiChi Peralta,ChiChi Peralta,,532899,60,5GNSVtCq2hiXDx7jUA5Iou,0,22,1,2,3,2,2,4,8,0.239772,0.255322,736.887031,4,0.000507
Sabino,Sabino,,588443,65,0zgFL90nGTrH2iOMD8Vysy,0,22,6,5,11,7,3,10,8,0.222003,0.238284,1314.944652,5,0.001424
Nicola Cruz,Nicola Cruz,,310007,52,0OltT51j3hIkgaDJqqPzDn,0,22,7,2,9,4,1,5,9,0.196501,0.207264,590.171259,5,0.001011
OV7,OV7,,1309826,59,5zaT4Qu9otu6z4oyWjRqM2,0,22,7,12,19,18,62,80,7,0.261342,0.287548,921.868992,5,0.000949
Kabah,Kabah,,782647,58,61hAcjvvUS6EXMpeeHwaDi,0,22,5,7,12,44,21,65,7,0.268419,0.294369,573.353919,5,0.000687
Fey,Fey,,1024388,58,3uC20p2EoNm5LYtzSVWdkL,0,22,4,7,11,8,16,24,8,0.230585,0.249299,42.263206,5,0.000633
Calo,Calo,,367632,56,2Qm12OdHFDHSpWhBMpO16L,0,22,7,7,14,23,81,104,7,0.246255,0.268359,491.050257,5,0.000918
The Sacados,The Sacados,,114234,50,55n0yLUMpJbCd20oPNRbo6,0,22,6,5,11,13,8,21,8,0.230585,0.249299,9.694382,5,0.000785
Magneto,Magneto,,866004,58,5v287QKYZ7Dyuw4CNzv89p,0,22,5,11,16,13,26,39,8,0.25367,0.280599,1274.385018,5,0.000711
Fabiana Cantilo,Fabiana Cantilo,,340340,53,5R6YR0pasdxlynyq0Abq7x,0,22,6,5,11,3,4,7,8,0.201917,0.212931,35.701037,5,0.000654
Luis Alberto Spinetta,Luis Alberto Spinetta,,686565,57,1MuQ2m2tg7naeRGAOxYZer,0,22,7,7,14,12,6,18,8,0.204057,0.216403,89.511818,5,0.001065
Pedro Aznar,Pedro Aznar,,290575,54,2FFrhWZS9vJsh2UvxYPRr6,0,22,9,8,17,21,8,29,8,0.248617,0.269925,776.630828,5,0.001112
Kike Pavón,Kike Pavón,,294574,52,2TkDdk47FGnvxcjQGDdPd0,0,22,8,8,16,11,7,18,9,0.204119,0.222758,217.305986,4,0.001502
Samuel Hernández,Samuel Hernández,,445125,52,17XxPdvl2MD39MnT9zhNjU,0,22,4,5,9,5,4,9,9,0.203441,0.219593,11.028683,4,0.000521
Musiko,Musiko,,157886,54,4A03xFVufDpEqOY9fQlFue,0,22,11,7,18,13,6,19,9,0.20338,0.21984,1499.002929,4,0.002524
Lead,Lead,,102082,50,5pyTY6jmdDNfKmmlo92Vfd,0,22,4,8,12,12,9,21,9,0.18128,0.199189,79.736215,4,0.000716
Girl Ultra,Girl Ultra,,111737,50,7i1CyQ1fogh4bkj3EPj3ls,0,22,4,3,7,4,4,8,8,0.212887,0.225876,490.420201,5,0.001519
Belanova,Belanova,,993805,62,3oNy8cjBtJzLC07I70sklp,0,22,1,1,2,1,1,2,8,0.210823,0.223419,97.396919,5,0.00037
Sergio Vargas,Sergio Vargas,,348177,52,4EzD52bDFGZTEeEucKHtDs,0,22,4,1,5,9,7,16,9,0.185063,0.194324,59.863251,5,0.000538
Tony Vega,Tony Vega,,736793,56,3Yg61bt7pZYX1bbMXEj8oY,0,22,7,5,12,4,2,6,8,0.227472,0.242719,78.843501,5,0.00076
Charles Ans,Charles Ans,,1180330,68,5lYeiQxUTcGKVgAuTqbTeL,0,22,9,4,13,9,8,17,8,0.2053,0.217225,2095.693963,5,0.002989
M2H,M2H,,139659,50,7bWN0FHvLppK8ozEH6exdi,0,22,4,4,8,6,4,10,8,0.231059,0.25006,979.220537,2,0.001351
Simpson Ahuevo,Simpson Ahuevo,,238553,56,6viZnVSHavFUcW0blu6Mvw,0,22,1,4,5,2,2,4,9,0.184962,0.19431,57.101761,5,0.001071
Gondwana,Gondwana,,984300,59,4nSgEvZncnC5oNPVrtwnLd,0,22,2,1,3,2,1,3,8,0.201495,0.211608,154.817778,5,0.000269
Emanero,Emanero,,57547,59,2BTS8Np1YzPQuXjgdlqsBB,0,22,5,4,9,9,5,14,8,0.232896,0.25221,1457.101193,2,0.000585
Dvicio,Dvicio,,1035828,62,2KxjMGXFgX1vt9grpbD3xI,0,22,3,9,12,3,19,22,6,0.287543,0.314812,294.840241,3,0.000728
Joe Vasconcellos,Joe Vasconcellos,,263624,53,4sGC7K2rSpWrWudBgYPMce,0,22,3,2,5,2,3,5,7,0.251774,0.271284,946.262086,5,0.000666
Moonkey,Moonkey,,85641,50,3qiQUUvazYmo7tBgQeb2rf,0,22,7,12,19,4,12,16,7,0.272764,0.305412,797.425085,2,0.000843
Recycled J,Recycled J,,183514,59,4bWHA8fMNjzfGPQqnh5D6y,0,22,14,9,23,34,94,128,8,0.234435,0.258932,774.04577,2,0.001326
Selecta,Selecta,,14712,50,1m9WPOccw8sizsVYUhSVjZ,0,22,4,10,14,77,13,90,8,0.261544,0.29184,527.904103,2,0.000937
Israel B,Israel B,,46256,57,16M8fuShcwX8uBDdmFZH9B,0,22,20,11,31,32,11,43,8,0.257252,0.278361,4161.615546,2,0.002133
Bardero$,Bardero$,,294384,58,5Q2fyL2TcdUY9IqKTkGk5G,0,22,8,6,14,5,18,23,8,0.227242,0.247838,70.449401,2,0.000603
Sergio Dalma,Sergio Dalma,,695371,57,7x6XYw3yCC67Pizi4o0wvZ,0,22,1,2,3,1,2,3,8,0.242533,0.259458,0,5,0.000381
Harry Nach,Harry Nach,,202781,64,0NnUMWDCDi1snuMja6IdxH,0,22,8,5,13,21,5,26,8,0.268955,0.299887,406.868042,1,0.001215
Luck Ra,Luck Ra,,247504,62,4kcQWQDK0u9AftVSpdrAgk,0,22,5,7,12,2,5,7,9,0.212753,0.229809,208.022123,2,0.000625
MYA,MYA,,468864,62,5Rj6rNR8zIlUUDCs1OyPmW,0,22,3,14,17,2,27,29,7,0.296004,0.33037,1275.127966,2,0.000366
Vicente Garcia,Vicente Garcia,,382100,62,2Otnykd696YidQYfEGVmNq,0,22,5,2,7,6,5,11,8,0.206432,0.217963,60.332256,5,0.000517
Elsa y Elmar,Elsa y Elmar,,147431,62,5nKGeITSNCVP76muyOlszy,0,22,7,1,8,10,1,11,8,0.179494,0.187421,546.477495,5,0.001071
Mœnia,Mœnia,,725418,62,3QmmtMrEf7aQrsd1VtejAV,0,22,3,6,9,7,12,19,8,0.235007,0.256804,118.710583,5,0.000516
Sentidos Opuestos,Sentidos Opuestos,,864169,54,1xJAOe5igcfHGUbMHxsTBq,0,22,5,4,9,17,7,24,7,0.255206,0.27683,541.75394,5,0.000706
Chusterfield,Chusterfield,,26375,51,3m6N2XBSZqfkujRvGYcdi8,0,22,4,4,8,1,1,2,9,0.169773,0.176747,87.434268,2,0.000283
Majo y Dan,Majo y Dan,,236070,55,0cEa9u1e3cDLXCZxxiuEmi,0,22,2,5,7,2,7,9,10,0.170073,0.182973,83.899056,4,0.000575
Alex Bueno,Alex Bueno,,213881,55,7esCoLcCoCK7FPa9casAH4,0,22,2,2,4,10,2,12,8,0.22686,0.243793,725.652311,5,0.000745
Ilegales,Ilegales,,125392,50,1hMa6SwU2t8eUEETAAbk9z,0,22,6,3,9,3,4,7,8,0.24825,0.270632,1101.623433,5,0.000992
Los Hermanos Rosario,Los Hermanos Rosario,,236885,50,40FzPNKgu0k9VMvvidiKCl,0,22,4,2,6,34,2,36,8,0.23724,0.256065,859.093559,5,0.001189
Aterciopelados,Aterciopelados,,681905,56,3MqjsWDLhq8SyY6N3PE8yW,0,22,2,6,8,1,8,9,7,0.26746,0.286834,162.053986,5,0.000262
Raly Barrionuevo,Raly Barrionuevo,,163919,50,0mdD8YXAyJDJ2BHxIKF0Yf,0,22,10,7,17,2,3,5,8,0.218973,0.230661,688.378587,5,0.000548
Yung Beef,Yung Beef,,313586,63,1rTUwYS38LkQTlT2fhikch,0,22,20,27,47,15,45,60,7,0.271665,0.306627,2041.715011,2,0.001034
Simon la Letra,Simon la Letra,,100767,61,6hYxQDiGct9yfRlSEv3F8a,0,22,1,1,2,1,2,3,8,0.217841,0.234312,0,2,0.000489
Golpe a Golpe,Golpe a Golpe,,402035,51,0nqpXa8bkBlWgS9FKhNCuj,0,22,2,8,10,1,11,12,7,0.278282,0.310962,25.693943,0,0.000339
Jeeiph,Jeeiph,,195835,53,6ZtLRqHEkAXPWVw0eRbDac,0,22,3,10,13,2,131,133,7,0.288651,0.326593,67.045899,0,0.000304
King Lil G,King Lil G,,393372,55,6L3x3if9RVimruryD9LoFb,0,22,6,3,9,2,1,3,9,0.209122,0.221692,0,2,0.000589
Rvfv,Rvfv,,281449,73,2CCgb0KApjfQDuTppovpf8,0,22,6,8,14,7,9,16,7,0.275327,0.305638,698.95931,3,0.000787
Nach,Nach,,770361,57,66ArjpKRgw8vYBf9yhktto,0,22,2,40,42,2,206,208,6,0.359467,0.410856,1764.77785,1,0.000292
Ms Nina,Ms Nina,,140433,52,43Hr2FjhVehkROIIEb7EfQ,0,22,4,2,6,2,4,6,8,0.225117,0.24444,216.284749,2,0.000515
Natos y Waor,Natos y Waor,,674953,62,1QJbbsxg2wqidJj51d3otw,0,22,7,15,22,6,29,35,8,0.244913,0.274995,847.389512,2,0.000919
El Jincho,El Jincho,,247085,55,2w1wJcGdJQ4Lw08oKBnDsw,0,22,13,11,24,13,9,22,8,0.251586,0.277985,2612.893142,0,0.001505
Denom,Denom,,120514,51,0fwnNjAay5ZHP5bAd63g8Y,0,22,10,19,29,11,12,23,8,0.230113,0.257705,3362.054995,2,0.000827
Blasfem,Blasfem,,6255,56,4FActBvkmDc8h3sI5vbMPZ,0,22,5,12,17,46,14,60,9,0.219258,0.245524,1258.322669,2,0.001246
Arce,Arce,,294647,51,7eH1UUCyxL8Wf9PztvvPJ6,0,22,2,7,9,2,10,12,7,0.265354,0.286979,1009.665276,2,0.000408
Dulce,Dulce,,390098,50,6ZYIXbXuZWooEUSJlRtew2,0,22,1,4,5,1,23,24,8,0.239602,0.257947,0,5,0.000385
Little Jesus,Little Jesus,,335601,57,5p1ARDx76hnOXoeigLIKit,0,22,4,5,9,5,7,12,8,0.213561,0.227533,417.235317,5,0.001552
Ceky Viciny,Ceky Viciny,,135534,53,5UopXhshFFqRIMfeZrBclq,0,22,12,18,30,50,57,107,7,0.283551,0.327038,536.636355,0,0.001328
Café Quijano,Café Quijano,,343392,56,2ECP3nWC88LaFz4oQzTo3Z,0,22,1,6,7,3,10,13,7,0.272433,0.296319,103.129607,5,0.000282
Daniela Spalla,Daniela Spalla,,111970,57,2VSRhqonKsL7KRAIk8SMmt,0,22,3,3,6,14,8,22,9,0.159602,0.166813,221.713529,5,0.00057
Flans,Flans,,604859,59,4zbqGb99bANxJBsvwRr2zT,0,22,1,1,2,2,1,3,9,0.214445,0.230666,9.747851,5,0.000278
Super Yei,Super Yei,,354562,62,6HqgxkTt9KGyt27zYrwVan,0,22,1,25,26,1,76,77,7,0.28927,0.338809,30.978335,0,0.000403
SFDK,SFDK,,584143,57,56n1NeXsTOOxjX3Z4lVMTJ,0,22,8,14,22,6,11,17,8,0.234353,0.251145,1161.236519,2,0.001369
Morodo,Morodo,,421772,53,2OnH4HpywAxWkSOEsyjdjn,0,22,13,5,18,4,1,5,9,0.195249,0.207752,107.961913,2,0.001298
Rapsusklei,Rapsusklei,,309252,51,451DVjaBuGYfvDfvG9MxaG,0,22,10,9,19,12,9,21,8,0.218264,0.234819,3132.351056,2,0.003027
ToteKing,ToteKing,,237285,51,224rbIjYbXaTI7lnP2ZMNJ,0,22,18,20,38,8,11,19,8,0.242533,0.268774,3344.047688,2,0.002207
Green Valley,Green Valley,,250651,51,1v7iZcyrm4fHfsEBiseomy,0,22,11,7,18,7,9,16,8,0.239943,0.258224,2196.802271,2,0.001511
Pepe : Vizio,Pepe : Vizio,,28590,50,4rvJ0Ktz2X2Erea9XUHxfu,0,22,5,9,14,5,11,16,8,0.239007,0.262283,240.568531,2,0.000671
LOWLIGHT,LOWLIGHT,,10589,53,7LHU5Uga349zOVMpDPf4ij,0,22,10,7,17,13,20,33,8,0.232494,0.254167,388.713723,2,0.001539
Ayax y Prok,Ayax y Prok,,562657,61,5Ypafuz95Xk09YDf4tgAvU,0,22,4,13,17,9,57,66,8,0.230664,0.256777,492.691758,2,0.000545
Dollar Selmouni,Dollar Selmouni,,66919,55,2544NCTfffschCn1NZVMSb,0,22,7,8,15,11,11,22,8,0.224368,0.245955,790.34446,2,0.00094
Foyone,Foyone,,156956,52,1F2erLLqRHbaFvEYHeVIHJ,0,22,16,16,32,14,26,40,8,0.229018,0.254898,2861.293817,2,0.001586
Hard GZ,Hard GZ,,207290,56,79N4S7UXdjo2fAh3OHJQuB,0,22,9,11,20,16,59,75,8,0.217841,0.237717,450.097931,2,0.000561
Juancho Marqués,Juancho Marqués,,138165,51,5JcO3FHEBbWTQMUHmWtU2g,0,22,12,13,25,5,4,9,9,0.222589,0.242429,118.901628,2,0.00059
Easy-S,Easy-S,,43852,50,4oNsvVnFz4HQ0UPpPFSuJX,0,22,9,5,14,12,8,20,10,0.191043,0.204097,124.239686,2,0.001117
Living,Living,,70550,51,2miffAnnUvKSyB9ykA2su9,0,22,3,1,4,3,1,4,10,0.165724,0.176553,0,4,0.000629
Los Abuelos De La Nada,Los Abuelos De La Nada,,514472,60,5R3NywPPOyhLfdvutgg0me,0,22,1,5,6,1,6,7,8,0.227395,0.243645,2156.452138,5,0.000509
Benjamín Amadeo,Benjamín Amadeo,,90137,50,6GYXfifD78PYARjZzxQzrG,0,22,2,7,9,1,8,9,7,0.274207,0.297135,694.75906,5,0.00033
Natalie Perez,Natalie Perez,,189757,61,1Y99HOeRzRc27my6NJE3rE,0,22,5,4,9,4,5,9,8,0.241491,0.26025,589.073295,5,0.000489
Los Tipitos,Los Tipitos,,435096,52,1SykQGBiBwkQ1fcGpJ1BJt,0,22,4,7,11,2,8,10,8,0.239347,0.25854,331.709336,5,0.00033
Toma Tu Lugar,Toma Tu Lugar,,168970,52,7xJZNfI5Yks87tn3ebHy9h,0,22,2,2,4,35,10,45,11,0.145698,0.153098,0,4,0.00182
Johnny Pacheco,Johnny Pacheco,,190817,50,09947uhj2ZwU9mFXK5v50o,0,22,6,4,10,15,45,60,8,0.198177,0.210451,968.478893,5,0.001069
Rojo,Rojo,,458637,52,5NvKO965JkIJanRuKQPVN6,0,22,3,2,5,1,2,3,8,0.231218,0.24525,1015.870344,4,0.000375
Los Claxons,Los Claxons,,448376,55,4AgfaZvOiSS97uy5ekQ7bf,0,22,3,1,4,2,1,3,8,0.209447,0.221289,24.482058,5,0.00028
La Zowi,La Zowi,,153296,52,1jB62pOe5WpGiHOBDtKBBG,0,22,7,5,12,7,2,9,8,0.217911,0.234559,4.813266,2,0.000389
JC el Diamante,JC el Diamante,,25189,50,1FxsUemFullSXJpySUsT0J,0,22,1,1,2,1,1,2,9,0.208217,0.22019,18.613956,3,0.000321
Generación 12,Generación 12,,419331,55,1w76rpst0I6hGUgCR2B33C,0,22,2,11,13,15,16,31,8,0.219974,0.244505,124.566995,4,0.000407
Los Manseros Santiagueños,Los Manseros Santiagueños,,224798,52,0IAWTLWnUIzKVQDTGoYJk2,0,22,4,3,7,1,1,2,9,0.179829,0.186628,0,5,0.000296
Lennis Rodriguez,Lennis Rodriguez,,56106,55,4Rzu63KnqMsThOdfkrJk1Z,0,22,7,5,12,7,8,15,8,0.262768,0.287154,1331.853031,3,0.000974
Rawayana,Rawayana,,395765,56,2AbQwU2cuEGfD465wCXlg2,0,22,4,5,9,2,5,7,8,0.22625,0.244233,848.449914,5,0.000448
Yiyo Sarante,Yiyo Sarante,,392750,58,2rwLjVHS15sfzciKXXNbgA,0,22,2,1,3,1,1,2,8,0.219472,0.233992,0,0,0.00042
La Factoria,La Factoria,,296579,65,4VsbQvC84B8Z3IsBY1HLQy,0,22,3,4,7,8,87,95,8,0.244824,0.270056,658.518075,6,0.000575
Mach & Daddy,Mach & Daddy,,102399,51,5Q1vijNjTVhQBoVrZVXms8,0,22,2,3,5,4,7,11,9,0.218194,0.236977,8.148218,6,0.000411
Gloosito,Gloosito,,20061,52,1MXug5KOetEEQjjvCPWwIm,0,22,5,6,11,2,2,4,8,0.219902,0.2386,0,2,0.000396
Kabasaki,Kabasaki,,4287,54,4rO00pQq33bIv73QyJdivX,0,22,13,11,24,12,18,30,8,0.24825,0.274723,2330.601858,2,0.001451
Saramalacara,Saramalacara,,106143,54,3QchzUOTSCKWmaRGEEiuir,0,22,6,2,8,5,1,6,10,0.156417,0.163791,1348.750866,2,0.001143
Soto Asa,Soto Asa,,112482,58,6gyhsZUy2fzzWZBRVPmOw4,0,22,5,5,10,2,10,12,8,0.237491,0.261078,8.633063,2,0.000285
El Búho,El Búho,,112791,51,1I7FVmvisCtSFzmm87mbLR,0,22,8,8,16,2,3,5,8,0.244469,0.265695,760.964628,5,0.001227
Karina,Karina,,216167,56,1QZuAtDYNrk2QMogJulsyq,0,22,1,3,4,1,2,3,8,0.213224,0.228713,463.618487,4,0.000529
Miranda,Miranda,,66331,50,0DjGDEVSQsodFbL1bMVPRs,0,22,9,19,28,5,25,30,6,0.294838,0.329896,2993.098031,5,0.000637
Cyril Kamer,Cyril Kamer,,55186,57,3J1MhhyXLJRNRZVrx11Lbf,0,22,2,3,5,2,2,4,8,0.230506,0.247799,103.638008,2,0.000272
Quantic,Quantic,,288709,59,5ZMwoAjeDtLJ0XRwRTgaK8,0,22,1,4,5,1,7,8,8,0.22894,0.248661,738.501448,5,0.000677
Milly,Milly,,43925,53,7kXCcNRLEnblbTAppPraBp,0,22,4,17,21,3,35,38,7,0.287298,0.328578,167.91166,0,0.000387
Eix,Eix,,30731,57,384MqcXCGGFh9UcjI5Tpc5,0,22,2,29,31,1,45,46,7,0.299157,0.349551,25.516352,0,0.000267
King Savagge,King Savagge,,94020,68,7DXregrznS25AM30UY9sUU,0,22,2,2,4,2,1,3,8,0.214445,0.229082,52.154504,2,0.000579
Chano,Chano,,136873,54,14lvrkdaXxggonwjKZpePM,0,22,1,4,5,1,12,13,8,0.247976,0.26558,108.43641,5,0.000298
Nekxum,Nekxum,,1859,52,4gZwJrNP5NG3KGS2dRcS5c,0,22,2,2,4,13,3,16,8,0.246255,0.268278,2.491109,0,0.000427
JC Reyes,JC Reyes,,64735,64,0FwnPHExlRRxEZPLAi5tmG,0,22,6,3,9,6,7,13,8,0.233784,0.254317,983.150531,0,0.001118
Calero LDN,Calero LDN,,114477,50,0VD8vX2wvCYYD0SMFCZeRR,0,22,12,12,24,6,2,8,8,0.199173,0.210365,871.096019,2,0.000912
Nikone,Nikone,,233894,53,105iYV1T7lf8Rysxo0KzfD,0,22,4,4,8,12,9,21,8,0.199881,0.212961,686.131108,2,0.000372
Lupita's Friends,Lupita's Friends,,4899,50,7gGKjAXKRyDUhSUhFDIaAW,0,22,9,15,24,46,17,63,7,0.240542,0.259919,849.978579,2,0.000407
Atomic Otro Way,Atomic Otro Way,,110616,58,05i5DIXDf4Ai4NEPEi3uBZ,0,22,4,1,5,3,1,4,9,0.216164,0.230732,6.824132,0,0.000588
Walls,Walls,,94692,55,6tvDaHOPNWfkc9Q8IghqSR,0,22,3,5,8,2,4,6,8,0.210559,0.222056,1877.663861,2,0.000679
Abhir Hathi,Abhir Hathi,,12663,65,2D8UzkIVdg1bj0Iqz6gjk0,0,22,5,5,10,2,10,12,9,0.199941,0.215104,76.016015,2,0.001073
Rojuu,Rojuu,,202657,62,04mTej6RpWzBxGwhfThpIi,0,22,10,7,17,6,6,12,9,0.21195,0.227202,711.460859,2,0.000714
Leïti Sene,Leïti Sene,,30885,52,5FQJWdcKPAijmEi4uroZ4h,0,22,9,9,18,4,6,10,8,0.235089,0.256443,187.136753,2,0.000504
BANDIDO,BANDIDO,,85290,55,7CSpCpNGTK9589bTi44SzE,0,22,1,3,4,1,5,6,7,0.262973,0.286855,1.487155,3,0.00028
YOVNGCHIMI,YOVNGCHIMI,,29096,54,4aSlfXDn9R60UlbZEboBUy,0,22,4,2,6,2,2,4,8,0.255497,0.282083,3.614755,0,0.000271
Granuja,Granuja,,78702,50,5KBPxIED8ejHkvhs4KCzyS,0,22,3,5,8,1,1,2,9,0.186497,0.198917,55.154841,2,0.000514
Cráneo,Cráneo,,152443,56,05aVtfDzBvg9eVu9MAZPGD,0,22,1,4,5,2,2,4,8,0.220405,0.238261,25.486425,2,0.000357
Juanfran,Juanfran,,124121,53,7zY0DMisq1oYXvNNgGwHBY,0,22,3,5,8,3,5,8,7,0.265041,0.294804,745.377324,0,0.000359
vf7,vf7,,52445,53,6bxjoq64Y0HTfMc4GIbpyJ,0,22,1,10,11,1,14,15,7,0.273539,0.307652,40.009157,0,0.000283
Dani J,Dani J,,46765,51,3TEhIeweC59okLmqFu6LWv,0,22,1,9,10,2,10,12,7,0.254052,0.276095,713.406009,4,0.000462
Mayo 214,Mayo 214,,71451,50,7uXKIO6VDeOCo6ImWZpZJn,0,22,4,7,11,1,2,3,7,0.231377,0.246909,479.546225,2,0.00061
Hens,Hens,,69653,57,3iY9PS7LxPnCVcCP7BjJOK,0,22,6,3,9,2,1,3,9,0.17398,0.180371,0,2,0.000415
TAICHU,TAICHU,,64624,52,3ou3XMRNmyDSy6gnC1bSgN,0,22,6,1,7,1,1,2,9,0.185216,0.196715,1348.750866,2,0.001194
Xavibo,Xavibo,,53617,50,3v2sYzsuZVd0gAhMWgl9I7,0,22,3,6,9,2,1,3,10,0.170979,0.180223,76.603329,2,0.000488
Cano,Cano,,92453,61,60ZOYUFnCYEeKYsxgvPxOS,0,22,3,6,9,5,16,21,7,0.274207,0.303868,1226.724501,0,0.000779
Orslok,Orslok,,74661,55,2TzPi0fPdqVesjZ3Y2wY43,0,22,3,1,4,1,1,2,10,0.17511,0.18374,56.11458,2,0.000359
Cardellino,Cardellino,,74618,56,7HFja6X48hWE58m3pQnGV0,0,22,1,5,6,1,5,6,8,0.223105,0.237115,255.526128,2,0.000347
El Bobe,El Bobe,,58299,58,3FtVhV92rZyHa7ot2ioG5a,0,22,6,4,10,1,4,5,8,0.237324,0.254543,78.480338,2,0.000585
